перевод: перевода переводы переводу перевод переводов 
страница: страница 
видеоклип: видеоклипы видеоклип 
социальный: социальные 
поддержать: поддержи 
связь: связь 
согласовывать: согласовывайте 
вчера: вчера 
мочь: могут 
понравиться: понравился понравиться 
нужно: нужно 
рождение: рождения 
сочувствие: сочувствие 
никто: никому никто никого 
автор: авторами авторы автора авторам автор 
бог: бог 
соглашение: соглашение 
рядом: рядом 
счастливый: счастливой счастлива 
спасти: спасёт 
хит: хит 
хотеть: хотели хочу 
чувствовать: чувствовать 
хотеться: хочется 
форум: форуме форум 
планета: планета 
ошибка: ошибки 
слишком: слишком 
треклист: треклист 
принадлежать: принадлежат 
предоставляться: предоставляются 
просить: прошу 
сеть: сети 
персональный: персональное 
просто: просто 
выйти: выйти 
тег: тегам 
её: её 
партнёрский: партнерская 
французский: французские 
колумбийский: колумбийского 
право: права 
немецкий: немецкие 
твой: твоё 
текст: текст 
возможность: возможность 
мой: мои 
хороший: хороший хорошим 
любовь: любви 
отказ: отказ 
трусиха: трусиха 
песня: песне песни песен 
потепление: потеплением 
поблагодарить: поблагодарить 
политика: политика 
разместить: разместить 
звук: звуки 
глобальный: глобальным 
парад: парад 
поэтому: поэтому 
рейтинг: рейтинг 
сайт: сайт сайтом 
р: р 
авторский: авторские 
наш: наши 
многое: многого 
исполнитель: исполнителя 
подписка: подписки 
общение: общение 
конфиденциальность: конфиденциальности 
паблик: паблик 
представиться: представьтесь 
интересный: интересное 
день: день 
видимо: видимо 
клип: клипов 
мнение: мнений 
ответственность: ответственности 
радио: радио 
услышать: услышать 
снова: снова 
всё: всё 
английский: английские 
событие: событие 
продюсер: продюсера 
итальянский: итальянские 
возможный: возможны 
обратный: обратная 
замечание: замечания 
худеть: худела 
испанский: испанские 
добавить: добавить 
поцеловать: поцеловать 
несоответствие: несоответствия 
популярный: популярные 
загрузка: загрузка 
честный: честный 
угадать: угадай 
одинокий: одинока 
разрушить: разрушена 
пожалуйста: пожалуйста 
человек: людьми 
равно: равно 
сообщить: сообщите 
издавать: издаваемые 
знать: знаю 
материал: материалов 
поцелуй: поцелуем поцелуй 
мы: нам 
некоторый: некоторые 
венера: венера 
полнеть: полнела 
пользовательский: пользовательское 
окно: окно 
авторизируться: авторизируйтесь 
отправить: отправить 
программа: программа 
любимый: любимые 
обитатель: обитатели 
пожелание: пожелания 
копирование: копирования 
киношный: киношным 
мелодия: мелодию 
нужный: нужна 
открывать: открываю 
игра: игра 
также: также 
кто: кого 
главный: главная 
быть: буду 
реклама: рекламу 
