перевод: перевода переводы переводу перевод переводов 
являть: являет 
бродить: бродить 
счастливый: счастлив 
видеоклип: видеоклипы видеоклип 
социальный: социальные 
поддержать: поддержи 
связь: связь 
любя: любя 
согласовывать: согласовывайте 
б: б 
мочь: могут 
понравиться: понравился понравиться 
рождение: рождения 
кисть: кисть 
автор: авторами авторы авторам автор 
соглашение: соглашение 
точка: точкой 
хит: хит 
ласкать: ласкал 
ошибка: ошибки 
форум: форуме форум 
исполнение: исполнении 
дрожь: дрожь 
делать: делать 
жить: жить 
блаженный: блажен 
вновь: вновь 
потеря: потерь потерю 
треклист: треклист 
принадлежать: принадлежат 
предоставляться: предоставляются 
сеть: сети 
ответить: ответь 
персональный: персональное 
просто: просто 
чей: чья 
выйти: выйти 
тег: тегам теги 
партнёрский: партнерская 
французский: французские 
право: права 
немецкий: немецкие 
казаться: кажется 
текст: текст 
сегодня: сегодня 
возможность: возможность 
неизвестный: неизвестен 
мой: мои 
тот: тех 
любовь: любви любовь 
отказ: отказ 
дождь: дождя 
песня: песне песни песня 
поблагодарить: поблагодарить 
мгла: мгле 
политика: политика 
разместить: разместить 
вариант: варианты вариант 
парад: парад 
рейтинг: рейтинг 
сайт: сайт сайтом 
стать: стал 
авторский: авторские 
наш: наши 
надежда: надежд 
день: дня день 
краска: краски 
человек: людей 
подписка: подписки 
общение: общение 
конфиденциальность: конфиденциальности 
паблик: паблик 
представиться: представьтесь 
знать: знает 
создать: создал 
интересный: интересное 
хотеть: хочу 
авторство: авторство 
клип: клипов 
дассный: дассен 
другой: другие 
мнение: мнений 
ответственность: ответственности 
радио: радио 
английский: английские 
событие: событие 
забыть: забыть 
итальянский: итальянские 
возможный: возможны 
обратный: обратная 
замечание: замечания 
испанский: испанские 
жизнь: жизни 
литературный: литературные 
ощущать: ощущал 
добавить: добавить 
средь: средь 
несоответствие: несоответствия 
популярный: популярные 
загрузка: загрузка 
угадать: угадай 
вид: вид 
слезинка: слезинок 
узнать: узнал 
пожалуйста: пожалуйста 
сообщить: сообщите 
тайна: тайну 
художник: художник 
этот: эта 
материал: материалов 
твой: твои 
мы: нам 
некоторый: некоторые 
смотреть: смотрю 
пользовательский: пользовательское 
авторизируться: авторизируйтесь 
хватать: хватает 
ложь: ложь 
отправить: отправить 
стихотворный: стихотворные 
программа: программа 
это: это 
любимый: любимые 
пожелание: пожелания 
придумать: придумал 
копирование: копирования 
мелодия: мелодию 
представить: представлена 
нужный: нужна 
игра: игра 
джо: джо 
глаз: глаза 
также: также 
указать: указать 
кто: кого 
главный: главная 
реклама: рекламу 
