перевод: перевода переводы переводу перевод переводов 
безумец: безумец 
страница: страница 
допустить: допустить 
видеоклип: видеоклипы видеоклип 
социальный: социальные 
расстаться: расстаться 
поддержать: поддержи 
кричать: кричать 
связь: связь 
согласовывать: согласовывайте 
являться: являюсь 
ты: тебе тобой 
мочь: могут могло 
понравиться: понравился понравиться 
защита: защиты 
автор: авторами авторы автора авторам автор 
соглашение: соглашение 
рядом: рядом 
действительно: действительно 
юлия: юлия 
хит: хит 
разумеется: разумеется 
который: которых которые которым которая 
ошибка: ошибки 
форум: форуме форум 
мирно: мирно 
битьё: битье 
слишком: слишком 
оиа: оиа 
смотреть: смотрел 
треклист: треклист 
король: король 
видеть: видишь 
предоставляться: предоставляются 
принадлежать: принадлежат 
сеть: сети 
персональный: персональное 
тайный: тайным 
выйти: выйти 
тег: тегам теги 
партнёрский: партнерская 
французский: французские 
становиться: становилась становился 
право: права 
немецкий: немецкие 
хранитель: хранителем 
фабиан: фабиан 
текст: текст 
способ: способы 
парад: парада парад 
горький: горькой 
тепло: теплом 
твой: твоей 
возможность: возможность 
свой: своим свои 
мой: мои 
мечта: мечты 
кончиться: кончатся 
сильно: сильно 
песня: песне песни 
отказ: отказ 
поблагодарить: поблагодарить 
политика: политика 
разместить: разместить 
рейтинг: рейтинг 
сайт: сайт сайтом 
авторский: авторские 
наш: наши 
каменный: каменном 
девочка: девочкой 
дом: доме 
слово: слова 
солдат: солдат 
кинозвезда: кинозвезда 
волк: волк 
подписка: подписки 
общение: общение 
конфиденциальность: конфиденциальности 
тишина: тишине 
тот: ту те 
паблик: паблик 
представиться: представьтесь 
интересный: интересное 
брат: брат 
война: войны 
клип: клипов 
другой: другие 
мнение: мнений 
ответственность: ответственности 
радио: радио 
хотеться: хотелось 
английский: английские 
итальянский: итальянские 
возможный: возможны 
помочь: помогло 
мужчина: мужчина 
обратный: обратная 
замечание: замечания 
испанский: испанские 
простить: простить 
решить: решила 
литературный: литературные 
кровь: крови кровь 
добавить: добавить 
улыбка: улыбки 
несоответствие: несоответствия 
популярный: популярные 
загрузка: загрузка 
угадать: угадай 
защищать: защищал 
сосуществовать: сосуществовали 
лидер: лидеры 
пожалуйста: пожалуйста 
вариант: вариант 
сообщить: сообщите 
окружать: окружал 
сатана: сатана 
материал: материалов 
мы: нам 
некоторый: некоторые 
маленький: маленькой 
украсть: украла 
пользовательский: пользовательское 
секрет: секреты 
тело: тел 
авторизируться: авторизируйтесь 
общий: общей 
любить: люблю любишь 
отправить: отправить 
стихотворный: стихотворные 
программа: программа 
посуда: посуды 
доверить: доверила 
существовать: существовали 
любимый: любимые 
мать: матерью 
пожелание: пожелания 
копирование: копирования 
мелодия: мелодию 
наверное: наверное 
игра: игра 
главный: главная 
быть: буду 
реклама: рекламу 
лара: лара 
танцевать: танцуем 
требовать: требовавшей 
