любовный: любовный 
перевод: перевода переводы переводу перевод переводов 
видеоклип: видеоклипы видеоклип 
социальный: социальные 
взять: возьмет 
слушать: слушали 
поддержать: поддержи 
связь: связь 
захотеть: захотеть 
голос: голосом 
согласовывать: согласовывайте 
ты: тебе 
мочь: могут 
понравиться: понравился понравиться 
вчера: вчера 
рождение: рождения 
совершенно: совершенно 
парень: парень парней 
автор: авторами авторы автора авторам автор 
соглашение: соглашение 
рок: рок 
почему: почему 
хит: хит 
пока: пока 
ошибка: ошибки 
форум: форуме форум 
причина: причина 
слишком: слишком 
музыка: музыка 
говорить: говорил говорили 
бояться: боюсь 
треклист: треклист 
принадлежать: принадлежат 
предоставляться: предоставляются 
который: который 
сеть: сети 
персональный: персональное 
захотеться: захотелось 
выйти: выйти 
просто: просто 
тег: тегам 
её: её 
партнёрский: партнерская 
французский: французские 
колумбийский: колумбийского 
право: права 
немецкий: немецкие 
продать: продать 
перезапустить: перезапусти 
текст: текст 
возможность: возможность 
сгореть: сгореть 
сказать: сказать 
мой: мои 
пытаться: пытается пытаюсь 
водить: водить 
отказ: отказ 
песня: песне песни песен песня 
поблагодарить: поблагодарить 
политика: политика 
разместить: разместить 
парад: парад 
оставить: оставить 
рейтинг: рейтинг 
сайт: сайт сайтом 
авторский: авторские 
наш: наши 
милый: милый 
поцеловаться: поцеловаться 
ночь: ночь 
женщина: женщина 
тошнить: тошнит 
исполнитель: исполнителя 
сколько: скольких 
подписка: подписки 
общение: общение 
конфиденциальность: конфиденциальности 
паблик: паблик 
представиться: представьтесь 
интересный: интересное 
день: день 
целовать: целовала 
клип: клипов 
мнение: мнений 
ответственность: ответственности 
закончиться: закончится 
радио: радио 
хотеться: хотелось 
английский: английские 
любовь: любовь 
событие: событие 
продюсер: продюсера 
итальянский: итальянские 
возможный: возможны 
мужчина: мужчина 
обратный: обратная 
нравиться: нравится 
замечание: замечания 
приятный: приятным 
испанский: испанские 
предложить: предложила 
остаться: остаться 
добавить: добавить 
поцеловать: поцеловать 
несоответствие: несоответствия 
популярный: популярные 
загрузка: загрузка 
сесть: сядь 
угадать: угадай 
пожалуйста: пожалуйста 
сообщить: сообщите 
себя: собой 
близкий: ближе 
материал: материалов 
мы: нам 
некоторый: некоторые 
немного: немного 
глупый: глупая 
пользовательский: пользовательское 
поцелуй: поцелуй 
авторизируться: авторизируйтесь 
сигарета: сигарета 
отправить: отправить 
спальня: спальне 
программа: программа 
пьяный: пьян 
это: это 
любимый: любимые 
пожелание: пожелания 
начать: начнешь 
копирование: копирования 
потащить: потащит 
переключиться: переключится 
мелодия: мелодию 
один: одну 
игра: игра 
рука: руку 
разрешить: разрешить 
главный: главная 
реклама: рекламу 
