перевод: перевода переводы переводу перевод переводов 
видеоклип: видеоклипы видеоклип 
очередь: очередь 
ничтожный: ничтожное 
социальный: социальные социальных 
боль: боль 
поддержать: поддержи 
связь: связь 
согласовывать: согласовывайте 
мочь: могут 
понравиться: понравился понравиться 
мир: мира 
объясняться: объяснялось 
сеть: сетях сети 
автор: авторами авторы авторам автор 
называть: называют 
соглашение: соглашение 
хит: хит 
несколько: несколько 
слово: слово слова 
чувствовать: чувствовать чувствует 
жизнь: жизнь 
ошибка: ошибки 
форум: форуме форум 
ребёнок: ребёнок дети ребёнком 
человек: человек человеку 
мёд: мёда 
весь: всём 
лететь: лечу 
неудобно: неудобно 
странно: странно 
треклист: треклист 
перевернуть: переверну 
оно: оно 
стараться: старалась 
василий: василий 
принадлежать: принадлежат 
предоставляться: предоставляются 
персональный: персональное 
бег: бегу 
выйти: выйти 
сдаваться: сдаюсь 
джеймс: джеймс 
тег: тегам теги 
значит: значит 
взлетать: взлетаю 
партнёрский: партнерская 
французский: французские 
страдание: страдании страдание 
приходить: приходит 
право: права 
немецкий: немецкие 
часто: часто 
кроме: кроме 
начаться: началось 
текст: текст 
парад: парада парад 
убежать: убежать 
возможность: возможность 
свой: своим своей 
сказать: сказать 
мой: мои мою моё 
неважно: неважно 
тот: тех 
любовь: любви 
отказ: отказ 
заново: заново 
созвучно: созвучно 
песня: песне песни песню 
поблагодарить: поблагодарить 
упоминание: упоминание 
политика: политика 
послушать: послушай 
разместить: разместить 
рейтинг: рейтинг 
сайт: сайт сайтом 
авторский: авторские 
отсутствие: отсутствии 
наш: наши 
нежный: нежное нежная 
якобы: якобы 
ночь: ночь 
определённый: определённой 
существо: существо 
ветер: ветром 
танец: танец 
твой: твоём 
рэппер: рэппер 
надежда: надежда 
подписка: подписки 
шум: шуме 
общение: общение 
конфиденциальность: конфиденциальности 
чуточку: чуточку 
чувство: чувствам 
представиться: представьтесь 
паблик: паблик 
дождь: дождём 
сердце: сердце 
знаменитый: знаменитый 
интересный: интересное 
который: которого которой которое 
хотеть: хочу 
кожевник: кожевников 
день: день 
менее: менее 
вынудить: вынуждены 
клип: клипов 
мнение: мнений 
ответственность: ответственности 
один: одна 
радио: радио 
снова: снова 
франция: франция 
английский: английские 
вести: ведёт 
событие: событие 
забыть: забыть 
итальянский: итальянские 
возможный: возможны 
обратный: обратная 
относиться: относится 
означать: означать означает 
замечание: замечания 
испанский: испанские 
литературный: литературные 
метро: метро 
добавить: добавить 
бродить: брожу 
несоответствие: несоответствия 
популярный: популярные 
загрузка: загрузка 
угадать: угадай 
огромный: огромно 
лидер: лидеры 
препятствовать: препятствует 
страна: стран страны 
идентификация: идентификации 
вариант: вариант 
сверкать: сверкающее 
пожалуйста: пожалуйста 
давать: даю 
сообщить: сообщите 
воля: волю 
написать: написал 
танцевать: танцую 
бессмысленный: бессмысленное 
украшение: украшение 
материал: материалов 
значение: значений 
ситуация: ситуации 
мы: нам 
некоторый: некоторые 
немного: немного 
безмерный: безмерную 
пользовательский: пользовательское 
приехать: приехал 
разный: разных 
авторизируться: авторизируйтесь 
путь: пути 
небо: небо 
стихотворный: стихотворные 
париж: париже 
отправить: отправить 
бороться: бороться 
программа: программа 
сколько: сколько 
керь: кери 
это: это 
любимый: любимые 
что: чему 
сладкий: сладком 
пожелание: пожелания 
копирование: копирования 
начинаться: начинаешься 
мелодия: мелодию 
игра: игра 
последний: последний 
заплатить: заплатила 
также: также 
родитель: родители 
гражданин: гражданами 
страшно: страшно 
появиться: появившееся 
главный: главная 
сладкое: сладкое 
обида: обиды 
реклама: рекламу 
