извинить: извините 
перевод: перевода переводы переводу перевод переводов 
страница: страница 
видеоклип: видеоклипы видеоклип 
социальный: социальные 
поддержать: поддержи 
слышать: слышать 
связь: связь 
согласовывать: согласовывайте 
вчера: вчера 
деньга: деньги 
такой: таком такая 
понравиться: понравился понравиться 
мочь: могут 
рождение: рождения 
лимузин: лимузин 
башня: башню 
автор: авторами авторы автора авторам автор 
соглашение: соглашение 
шанель: шанель 
лицемерие: лицемерие 
хит: хит 
ритц: ритц 
кирилл: кирилл 
открыть: откроем 
шаблонный: шаблонные 
хотеться: хочется 
форум: форуме форум 
ошибка: ошибки 
слишком: слишком 
делать: делать 
треклист: треклист 
принадлежать: принадлежат 
предоставляться: предоставляются 
сеть: сети 
номер: номер 
персональный: персональное 
выйти: выйти 
тег: тегам теги 
конченый: кончено 
партнёрский: партнерская 
французский: французские 
право: права 
немецкий: немецкие 
текст: текст 
стереотип: стереотипы 
парад: парада парад 
возможность: возможность 
подарить: подарите 
манера: манеры 
мой: мои мою 
случай: случае 
алай: алая 
драгоценность: драгоценности 
любовь: любви 
отказ: отказ 
песня: песне песни песню 
посмотреть: посмотрите 
поблагодарить: поблагодарить 
политика: политика 
разместить: разместить 
рейтинг: рейтинг 
надоесть: надоело надоели 
хороший: хорошего хорошие 
сайт: сайт сайтом 
авторский: авторские 
наш: наши 
гранд: гранд 
ваш: ваши 
забыть: забудьте 
клюев: клюев 
добро: добро 
эквиритмический: эквиритмические 
невшатель: невшатель 
алла: алла 
подписка: подписки 
настроение: настроения 
общение: общение 
конфиденциальность: конфиденциальности 
паблик: паблик 
представиться: представьтесь 
речь: речи 
небольшой: небольшой 
отсюда: отсюда 
интересный: интересное 
хотеть: хочу 
осчастливить: осчастливят 
день: день 
клип: клипов клип 
мнение: мнений 
ответственность: ответственности 
дать: дайте 
сваливать: сваливаю 
радио: радио 
пожаловать: пожаловать 
английский: английские 
люкс: люкс 
откроить: открою 
событие: событие 
сердиться: сержусь 
итальянский: итальянские 
возможный: возможны 
обратный: обратная 
замечание: замечания 
испанский: испанские 
реальность: реальность 
литературный: литературные 
добавить: добавить 
откровенный: откровенна 
отель: отеле 
давать: давайте 
несоответствие: несоответствия 
популярный: популярные 
загрузка: загрузка 
свобода: свободу 
угадать: угадай 
лидер: лидеры 
говорить: говорю 
пожалуйста: пожалуйста 
вариант: вариант 
чистый: чистой 
сообщить: сообщите 
материал: материалов 
громко: громко 
любой: любом 
радость: радости 
мы: нам 
некоторый: некоторые 
пользовательский: пользовательское 
есть: ем 
авторизируться: авторизируйтесь 
замок: замок 
совесть: совестью 
умереть: умереть 
отправить: отправить 
стихотворный: стихотворные 
программа: программа 
тюрнина: тюрнина 
екатеринбург: екатеринбург 
полина: полина 
логин: логин 
это: это 
любимый: любимые 
пожелание: пожелания 
копирование: копирования 
папалапапап: папалапапапа 
мелодия: мелодию 
эйфелев: эйфелеву 
рука: руками 
персонал: персонал 
игра: игра 
главный: главная 
реклама: рекламу 
