связь: связь 
торчать: торчит 
автор: автор авторы авторами авторам 
сила: сил 
общение: общение 
перевод: переводов переводу перевода переводы перевод 
рожать: рожавшей 
подбрасывать: подбрасываю 
седой: седой 
рейтинг: рейтинг 
нанизывать: нанизываю 
текст: текст 
цепь: цепь 
видеоклип: видеоклипы видеоклип 
испанский: испанские 
загрузка: загрузка 
отказ: отказ 
политика: политика 
интересный: интересное 
семя: семени 
форум: форум форуме 
принадлежать: принадлежат 
возможный: возможны 
выйти: выйти 
понравиться: понравился понравиться 
это: этим 
радио: радио 
популярный: популярные 
родимый: родимое 
сеть: сети 
один: одна одно 
поцелуй: поцелуем 
право: права 
жить: живёт 
наш: наши 
желать: желаю 
сайт: сайтом сайт 
дать: дай дал 
мелодия: мелодию 
поклясться: поклялся 
утопить: утоплю 
светить: светит 
клип: клипов 
возможность: возможность 
живот: животе 
горло: горле 
соска: соски 
раммштайна: раммштайн 
хит: хит 
спешка: спешке 
тег: тегам 
английский: английские 
болезнь: болезнью 
персональный: персональное 
солнце: солнце 
имя: имени 
мама: мама 
паблик: паблик 
истечь: истечь 
мой: мои моём 
итальянский: итальянские 
угорь: угорь 
кровь: кровью 
мнение: мнений 
облизывать: облизывать 
главный: главная 
авторизируться: авторизируйтесь 
мокрый: мокрую 
ответственность: ответственности 
пожелание: пожелания 
пупок: пупка 
волос: волос 
конфиденциальность: конфиденциальности 
несоответствие: несоответствия 
материал: материалов 
мочь: мог могут 
ночью: ночью 
немецкий: немецкие 
никто: никто 
песня: песне песни 
авторский: авторские 
подписка: подписки 
лоб: лбу 
французский: французские 
пожалуйста: пожалуйста 
разместить: разместить 
складка: складок 
пятно: пятно 
поблагодарить: поблагодарить 
умереть: умереть 
предоставляться: предоставляются 
одарить: одарю 
грудь: грудь 
некоторый: некоторые 
замечание: замечания 
лёгкий: лёгких 
воздух: воздух 
обратный: обратная 
копирование: копирования 
удаль: удали 
парад: парад 
зачать: зачат 
нож: ножа 
спрятаться: спрятаться 
давать: даёт 
игра: игра 
добавить: добавить 
вслед: вслед 
детвора: детворы 
соглашение: соглашение 
белый: белый 
река: реке 
отправить: отправить 
молоко: молока 
партнёрский: партнерская 
ошибка: ошибки 
представиться: представьтесь 
поддержать: поддержи 
треклист: треклист 
любимый: любимые 
пользовательский: пользовательское 
социальный: социальные 
её: её 
сообщить: сообщите 
мать: матери 
мы: нам 
согласовывать: согласовывайте 
слеза: слёзы 
реклама: рекламу 
трубка: трубка 
сегодня: сегодня 
должный: должен 
угадать: угадай 
программа: программа 
