твой: твоей твой 
связь: связь 
поддерживать: поддерживая 
автор: автор авторы авторами автора авторам 
пожинать: пожинаешь 
обозначать: обозначает 
общение: общение 
перевод: переводов переводу перевода переводы перевод 
грань: грани 
остаться: осталось 
превратить: преврати 
рейтинг: рейтинг 
достигать: достигает 
текст: текст 
вообще: вообще 
стихотворный: стихотворные 
помочь: поможет 
парад: парада парад 
один: одну 
описать: описала 
видеоклип: видеоклипы видеоклип 
испанский: испанские 
загрузка: загрузка 
идти: идем идя 
находиться: находилось находясь 
отказ: отказ 
бездыханный: бездыханной 
интересный: интересное 
политика: политика 
быть: будешь будут 
форум: форум форуме 
жалеть: жалеть 
детка: детка 
уходить: уходи ухожу 
принадлежать: принадлежат 
отчаяние: отчаяния 
возможный: возможны 
посеять: посеял 
выйти: выйти 
понравиться: понравился понравиться 
радио: радио 
популярный: популярные 
сеть: сети 
рассказать: рассказать 
сленговый: сленгового 
право: права 
такт: такт 
наш: наши 
скатываться: скатываясь 
дверь: дверь 
уносить: унося 
стоить: стоит 
сайт: сайтом сайт 
сделать: сделать 
душа: душа 
себя: собой 
делить: делить 
мелодия: мелодию 
драгоценный: драгоценное 
мочь: могло могу могут 
золото: золото 
чисто: чисто 
встретить: встретил 
клип: клипов 
мой: моем мои мое 
возможность: возможность 
продать: продай 
любой: любую 
литься: литься 
разоблачить: разоблачу 
одинокий: одинок 
получиться: получилось 
видеть: вижу 
сердце: сердце 
хит: хит 
лидер: лидеры 
шрам: шрамы 
они: ними 
внизу: внизу 
тег: тегам теги 
английский: английские 
персональный: персональное 
чувство: чувством 
паблик: паблик 
частичка: частичку 
итальянский: итальянские 
эквиритмический: эквиритмические 
думать: думать 
мнение: мнений 
марат: марат 
ты: тебе тобой 
главный: главная 
недооценивать: недооценивать 
авторизируться: авторизируйтесь 
свой: свой 
ответственность: ответственности 
история: историю 
пожелание: пожелания 
дно: дну дно 
конфиденциальность: конфиденциальности 
играть: играл 
несоответствие: несоответствия 
материал: материалов 
слышать: слышала 
кристально: кристально 
темнота: темноты 
вместе: вместе 
немецкий: немецкие 
огонь: огонь 
любовь: любви 
пожалеть: пожалеешь 
друг: друга друг 
песня: песне песни 
авторский: авторские 
посмотреть: посмотри 
подписка: подписки 
каждый: каждую 
хотеть: хочу 
выражение: выражения выражение 
напоминать: напоминают 
вспыхивать: вспыхивает 
искать: ищешь 
найти: найти 
о: обо 
французский: французские 
слеза: слезы 
пожалуйста: пожалуйста 
разместить: разместить 
собственный: собственный 
поблагодарить: поблагодарить 
оставлять: оставляют 
выводить: выводит 
предоставляться: предоставляются 
некоторый: некоторые 
замечание: замечания 
хороший: хорошее 
кто: кем кого 
экипаж: экипаж 
гора: горе 
поддержать: поддержит поддержи 
обратный: обратная 
джумагазий: джумагазиев 
копирование: копирования 
слово: словам 
заплатить: заплати 
игра: игра 
давать: давай 
нечего: нечего 
двое: двоих 
просто: просто 
название: название 
весь: весь 
добавить: добавить 
справиться: справиться 
соглашение: соглашение 
подумать: подумай 
отправить: отправить 
смотреть: смотри 
товар: товаром 
заставлять: заставляют 
открытый: открытую 
партнёрский: партнерская 
страница: страница 
перевести: перевести 
ошибка: ошибки 
представиться: представьтесь 
треклист: треклист 
любимый: любимые 
пользовательский: пользовательское 
апогей: апогея 
собираться: собираюсь 
социальный: социальные 
дом: дом 
сообщить: сообщите 
оно: оно 
мы: нам 
иметь: иметь 
согласно: согласно 
литературный: литературные 
адель: адель 
согласовывать: согласовывайте 
реклама: рекламу 
вариант: вариант 
грэмми: грэмми 
рука: руках 
угадать: угадай 
программа: программа 
к: ко 
