правда: правду 
связь: связь 
автор: автор авторы авторами авторам 
ненавидеть: ненавижу 
солгать: солгу 
общение: общение 
перевод: переводов переводу перевода переводы перевод 
рейтинг: рейтинг 
текст: текст 
винить: виню 
подходить: подхожу 
видеоклип: видеоклипы видеоклип 
убить: убью 
твой: твоими твоих 
испанский: испанские 
загрузка: загрузка 
любить: люблю 
отказ: отказ 
интересный: интересное 
политика: политика 
одинокий: одинокой 
форум: форум форуме 
детка: детка 
принадлежать: принадлежат 
возможный: возможны 
умереть: умру 
выйти: выйти 
понравиться: понравился понравиться 
радио: радио 
определить: определить 
популярный: популярные 
уйти: уйти 
сеть: сети 
рассказать: рассказать 
проходимый: проходим 
мой: моего мои 
право: права 
наш: наши 
вини: вини 
сайт: сайтом сайт 
пытаться: пытаюсь 
чувствовать: чувствую 
любовь: любовь 
мелодия: мелодию 
особенно: особенно 
знать: знаешь знаю знай 
забрать: забрать 
клип: клипов 
чувство: чувствами чувство 
возможность: возможность 
остаться: остаться 
честный: честен 
один: одной 
сложно: сложно 
изменить: изменят 
видеть: вижу 
хит: хит 
тег: тегам 
английский: английские 
персональный: персональное 
паблик: паблик 
боль: боль 
итальянский: итальянские 
мнение: мнений 
ты: тебе тобой 
главный: главная 
авторизируться: авторизируйтесь 
позволить: позволить позволь 
найти: найдешь найти 
ответственность: ответственности 
пожелание: пожелания 
решение: решения 
конфиденциальность: конфиденциальности 
страшно: страшно 
мы: нами нам 
плакать: плачешь 
несоответствие: несоответствия 
материал: материалов 
ночью: ночью 
немецкий: немецкие 
вместе: вместе 
авторский: авторские 
песня: песне песни 
глаз: глазах 
подписка: подписки 
хотеть: хочу хочешь 
думать: думаю 
быть: буду 
случаться: случается 
о: обо 
французский: французские 
мочь: могу могут 
пожалуйста: пожалуйста 
разместить: разместить 
поблагодарить: поблагодарить 
управлять: управлять 
предоставляться: предоставляются 
некоторый: некоторые 
замечание: замечания 
пусть: пусть 
идеальный: идеальная 
время: время 
обратный: обратная 
копирование: копирования 
парад: парад 
игра: игра 
узнать: узнаешь 
делать: делает 
просто: просто 
добавить: добавить 
расстояние: расстояние 
соглашение: соглашение 
отправить: отправить 
что: чём 
это: это 
партнёрский: партнерская 
раздражать: раздражает 
никто: никого 
малышка: малышка 
ошибка: ошибки 
весь: всём 
представиться: представьтесь 
поддержать: поддержи 
треклист: треклист 
любимый: любимые 
пользовательский: пользовательское 
социальный: социальные 
постоянно: постоянно 
сообщить: сообщите 
стоить: стоишь 
причина: причину 
скучать: скучать 
согласовывать: согласовывайте 
навсегда: навсегда 
реклама: рекламу 
сегодня: сегодня 
девочка: девочка 
говорить: говорю 
угадать: угадай 
выходить: выходит 
программа: программа 
сказать: сказать 
