связь: связь 
автор: автор авторы авторами авторам 
бояться: бойтесь 
общение: общение 
перевод: переводов переводу перевода переводы перевод 
ринг: ринг 
рейтинг: рейтинг 
слишком: слишком 
текст: текст 
первоначальный: первоначальное 
написать: написана 
семь: семь 
стихотворный: стихотворные 
парад: парада парад 
свет: света 
украинский: украинского 
видеоклип: видеоклипы видеоклип 
испанский: испанские 
загрузка: загрузка 
отказ: отказ 
громко: громко 
вырываться: вырывается 
шесть: шесть 
интересный: интересное 
политика: политика 
форум: форум форуме 
принадлежать: принадлежат 
яркий: яркая 
возможный: возможны 
самый: самая 
упасть: упадет 
выйти: выйти 
понравиться: понравился понравиться 
радио: радио 
жар: жар 
четыре: четыре 
популярный: популярные 
сеть: сети 
право: права 
наш: наши 
звучать: звучать 
сайт: сайтом сайт 
глаз: глаз 
мелодия: мелодию 
рука: рук 
кличко: кличко 
светить: светит 
клип: клипов 
возможность: возможность 
однако: однако 
девять: девять 
отказаться: отказался 
раммштайна: раммштайн 
ложиться: ложится 
хит: хит 
обжечь: обжечь 
лидер: лидеры 
тег: тегам теги 
английский: английские 
персональный: персональное 
солнце: солнце 
боль: боль 
ждать: ждут 
паблик: паблик 
вчера: вчера 
мой: мои моих 
итальянский: итальянские 
должный: должна 
кулак: кулаков 
мнение: мнений 
главный: главная 
нокдаун: нокдаун 
авторизируться: авторизируйтесь 
восходить: восходит 
считать: считает 
мир: мир 
песня: песня песне песни 
ответственность: ответственности 
пожелание: пожелания 
рождение: рождения 
десять: десяти 
конфиденциальность: конфиденциальности 
несоответствие: несоответствия 
материал: материалов 
ночью: ночью 
немецкий: немецкие 
авторский: авторские 
подписка: подписки 
пять: пять 
жёсткий: жёсткий 
французский: французские 
небо: небес 
звезда: звезда 
пожалуйста: пожалуйста 
разместить: разместить 
боксёр: боксёра боксёр 
выход: выхода 
поблагодарить: поблагодарить 
зайти: зайдёт 
предоставляться: предоставляются 
грудь: грудь 
некоторый: некоторые 
замечание: замечания 
посылать: посылает 
время: время 
лицо: лицо 
обратный: обратная 
копирование: копирования 
игра: игра 
название: название 
добавить: добавить 
бой: боя 
соглашение: соглашение 
отправить: отправить 
мочь: могут 
восемь: восемь 
ослепить: ослепить 
теряться: теряется 
виталий: виталия 
партнёрский: партнерская 
начало: началом 
ошибка: ошибки 
представиться: представьтесь 
тяжёлый: тяжёлой 
поддержать: поддержи 
треклист: треклист 
любимый: любимые 
пользовательский: пользовательское 
конец: конец 
социальный: социальные 
её: её 
событие: событие 
сообщить: сообщите 
оно: оно 
мы: нам 
литературный: литературные 
согласовывать: согласовывайте 
реклама: рекламу 
сегодня: сегодня 
равновесие: равновесие 
вариант: вариант 
угадать: угадай 
день: день 
причинять: причиняя 
программа: программа 
посчитать: посчитав 
