выжать: выжать 
связь: связь 
автор: автор авторы авторами автора авторам 
ребёнок: ребёнок 
выбраться: выбраться 
земля: земле 
общение: общение 
перевод: переводов переводу перевода переводы перевод 
два: двумя 
особенный: особенную 
рейтинг: рейтинг 
текст: текст 
один: одну 
видеоклип: видеоклипы видеоклип 
испанский: испанские 
загрузка: загрузка 
отказ: отказ 
политика: политика 
интересный: интересное 
надеяться: надеюсь 
форум: форум форуме 
принадлежать: принадлежат 
возможный: возможны 
выйти: выйти 
он: нему 
пробка: пробками 
понравиться: понравился понравиться 
радио: радио 
популярный: популярные 
сеть: сети 
право: права 
наш: наши 
девочка: девочку 
юз: юзу 
приносить: приносит 
сайт: сайтом сайт 
глаз: глаз глазах 
мелодия: мелодию 
любимый: любимая любимые 
хулиган: хулиганом 
клип: клипов 
ещё: ещё 
красивый: красивый 
возможность: возможность 
стоять: стоять 
мозг: мозг 
который: который 
помощь: помощь 
создать: создать 
хит: хит 
свой: своём 
тег: тегам 
английский: английские 
персональный: персональное 
утром: утром 
паблик: паблик 
боль: боль 
джульетта: джульетту джульетта 
вчера: вчера 
пристрелить: пристрелить 
мой: мои мою 
итальянский: итальянские 
мнение: мнений 
гораздо: гораздо 
главный: главная 
больший: большим 
мальчик: мальчик 
авторизируться: авторизируйтесь 
ответственность: ответственности 
голова: голове головы 
рождение: рождения 
пожелание: пожелания 
думать: думает 
кислый: кислый 
конфиденциальность: конфиденциальности 
знать: знаю 
несоответствие: несоответствия 
материал: материалов 
немецкий: немецкие 
смочь: смогу 
никто: никто 
неужели: неужели 
сила: силу 
кровать: кровати 
песня: песне песни 
подписка: подписки 
хотеть: хочу 
авторский: авторские 
быть: буду 
чёрт: чёрт 
бежать: бежать 
французский: французские 
мочь: могу могут 
пожалуйста: пожалуйста 
разместить: разместить 
вести: веду 
сидеть: сидеть 
плакать: плакать 
поблагодарить: поблагодарить 
предоставляться: предоставляются 
некоторый: некоторые 
замечание: замечания 
обратный: обратная 
копирование: копирования 
парад: парад 
игра: игра 
просто: просто 
добавить: добавить 
нужно: нужно 
соглашение: соглашение 
ради: ради 
отправить: отправить 
увидеть: увидеть 
пробиться: пробиться 
партнёрский: партнерская 
поверить: поверить 
страница: страница 
умереть: умер 
ошибка: ошибки 
представиться: представьтесь 
поддержать: поддержи 
треклист: треклист 
пользовательский: пользовательское 
социальный: социальные 
твой: твоя 
её: её 
событие: событие 
смотреть: смотрит 
сообщить: сообщите 
мы: нам 
больно: больно 
скучать: скучать 
согласовывать: согласовывайте 
реклама: рекламу 
должный: должен 
угадать: угадай 
нужный: нужна 
цвет: цвет 
день: день 
программа: программа 
видеть: видел 
понимать: понимать 
