сердце: сердца сердце 
связь: связь 
пустота: пустоту 
приходить: приходит 
автор: автор авторы авторами автора авторам 
сладость: сладость 
грусть: грусть 
общение: общение 
перевод: переводов переводу перевода переводы перевод 
настоящий: настоящая 
татьяна: татьяна 
рейтинг: рейтинг 
текст: текст 
парад: парада парад 
видеоклип: видеоклипы видеоклип 
любовь: любовью любовь 
неотъемлемый: неотъемлемую 
испанский: испанские 
загрузка: загрузка 
отказ: отказ 
политика: политика 
интересный: интересное 
форум: форум форуме 
принадлежать: принадлежат 
возможный: возможны 
валерий: валерий 
выйти: выйти 
петрович: петрович 
понравиться: понравился понравиться 
ужин: ужины 
радио: радио 
популярный: популярные 
счастие: счастьем 
сеть: сети 
каратеев: каратеев 
право: права 
наш: наши нашей нашим 
олег: олег 
сайт: сайтом сайт 
ранний: раньше 
гоцуляк: гоцуляк 
белов: белов 
исчезать: исчезает 
мелодия: мелодию 
евгениевич: евгеньевич 
холодный: холодную 
любим: любим 
буслаев: буслаев 
стать: стала 
б: б 
юрий: юрий 
клип: клипов 
возможность: возможность 
сделать: сделала 
который: которую 
невозвратимый: невозвратимые 
хит: хит 
спрятать: спрятала 
лидер: лидеры 
тег: тегам теги 
английский: английские 
персональный: персональное 
паблик: паблик 
мой: мои 
итальянский: итальянские 
мнение: мнений 
море: море 
главный: главная 
превратиться: превратилась превратилось 
мысль: мысль 
авторизируться: авторизируйтесь 
ответственность: ответственности 
история: историю 
пожелание: пожелания 
челентано: челентано 
горький: горьким 
конфиденциальность: конфиденциальности 
ломакин: ломакина 
несоответствие: несоответствия 
материал: материалов 
немецкий: немецкие 
авторский: авторские 
песня: песне песни 
подписка: подписки 
сказать: сказала 
французский: французские 
пожалуйста: пожалуйста 
разместить: разместить 
улыбка: улыбки 
льшуя: льшую 
поблагодарить: поблагодарить 
признаться: признайся 
послевкусие: послевкусием 
хотеть: хочешь 
почему: почему 
предоставляться: предоставляются 
некоторый: некоторые 
замечание: замечания 
игорь: игорь 
обратный: обратная 
копирование: копирования 
любить: любит 
игра: игра 
единственный: единственный 
потихоньку: потихоньку 
воспоминание: воспоминание 
добавить: добавить 
ванна: ванна 
вечер: вечер 
соглашение: соглашение 
отправить: отправить 
мочь: могут 
твой: твой твоя 
внутри: внутри 
открыть: откроет 
партнёрский: партнерская 
сцена: сцены 
страница: страница 
ошибка: ошибки 
представиться: представьтесь 
поддержать: поддержи 
треклист: треклист 
любимый: любимые 
пользовательский: пользовательское 
социальный: социальные 
женщина: женщиной 
денис: денис 
воронов: воронов 
сообщить: сообщите 
оно: оно 
дрожь: дрожь 
мы: нам 
согласовывать: согласовывайте 
адриано: адриано 
реклама: рекламу 
вариант: вариант 
угадать: угадай 
программа: программа 
