скоро: скоро 
связь: связь 
ночь: ночи 
ум: ума 
автор: автор авторы авторами автора авторам 
сердце: сердцем 
общение: общение 
перевод: переводов переводу перевода переводы перевод 
хотеть: хотела хочу 
самый: самым 
смерть: смерти 
окно: окном 
рейтинг: рейтинг 
новый: новое 
текст: текст 
видеоклип: видеоклипы видеоклип 
телефон: телефона 
испанский: испанские 
загрузка: загрузка 
любить: люблю любила 
отказ: отказ 
интересный: интересное 
политика: политика 
нравиться: нравиться 
форум: форум форуме 
принадлежать: принадлежат 
пока: пока 
возможный: возможны 
выйти: выйти 
гроза: гроза 
понравиться: понравился понравиться 
радио: радио 
популярный: популярные 
сеть: сети 
поцелуй: поцелуем 
мой: моего мои 
право: права 
закончиться: закончилась 
наш: наши 
сходить: сходить 
сайт: сайтом сайт 
любовь: любовь любви 
который: которая 
мелодия: мелодию 
клип: клипов 
забыть: забыть 
подобно: подобно 
возможность: возможность 
порыв: порыв 
разбитый: разбитым 
умный: умным 
снова: снова 
хит: хит 
оставить: оставив 
тег: тегам 
английский: английские 
персональный: персональное 
паблик: паблик 
итальянский: итальянские 
должный: должна 
мнение: мнений 
ты: тебе тобой 
радость: радости 
главный: главная 
жизнь: жизнь 
авторизируться: авторизируйтесь 
ответственность: ответственности 
пожелание: пожелания 
конфиденциальность: конфиденциальности 
знать: знаю 
несоответствие: несоответствия 
материал: материалов 
словно: словно 
скоротечный: скоротечным 
немецкий: немецкие 
песня: песне песни 
авторский: авторские 
подписка: подписки 
каждый: каждую 
думать: думаю 
быть: буду е 
сумасшедший: сумасшедшей 
чувство: чувство 
французский: французские 
пожалуйста: пожалуйста 
разместить: разместить 
говорить: говоришь 
околдовать: околдована 
поблагодарить: поблагодарить 
ветер: ветра 
предоставляться: предоставляются 
некоторый: некоторые 
замечание: замечания 
секунда: секунду 
обратный: обратная 
первый: первая первым 
копирование: копирования 
парад: парад 
номер: номер 
игра: игра 
добавить: добавить 
соглашение: соглашение 
отправить: отправить 
мочь: могут 
твой: твой 
это: это 
мираж: мираж 
восстановиться: восстановлюсь 
дождь: дождь 
партнёрский: партнерская 
молния: молнии 
удалить: удалю 
страница: страница 
ошибка: ошибки 
представиться: представьтесь 
поддержать: поддержи 
треклист: треклист 
любимый: любимые 
пользовательский: пользовательское 
социальный: социальные 
сообщить: сообщите 
мы: нам 
согласовывать: согласовывайте 
грохотать: грохочет 
реклама: рекламу 
обмануть: обманул 
угадать: угадай 
программа: программа 
