связь: связь 
этот: эта 
автор: автор авторы авторами автора авторам 
общение: общение 
терять: теряешь 
перевод: переводов переводу перевода переводы перевод 
грань: грани 
советский: советском 
год: году года 
фаррес: фарреса 
рейтинг: рейтинг 
текст: текст 
монтьель: монтьель 
парад: парада парад 
видеоклип: видеоклипы видеоклип 
испанский: испанские 
загрузка: загрузка 
фильм: фильм фильму фильма 
отказ: отказ 
прокат: прокате 
интересный: интересное 
политика: политика 
написать: написанная 
форум: форум форуме 
принадлежать: принадлежат 
возможный: возможны 
женский: женскую 
выйти: выйти 
понравиться: понравился понравиться 
какой: каких 
радио: радио 
популярный: популярные популярная 
сеть: сети 
пора: пор 
право: права 
наш: наши 
сайт: сайтом сайт 
любовный: любовное 
исполнить: исполнила 
мелодия: мелодию 
гнездо: гнездо 
тереса: тересы 
клип: клипов 
возможность: возможность 
думать: думая 
день: дни 
острый: острой 
шпионский: шпионское 
святой: святого 
каждый: каждый 
хит: хит 
лидер: лидеры 
тег: тегам теги 
английский: английские 
персональный: персональное 
паблик: паблик 
мой: мои 
итальянский: итальянские 
мнение: мнений 
коул: коула 
касабланка: касабланке 
екатерина: екатерина 
также: также 
сара: сара сары 
главный: главная главную 
авторизируться: авторизируйтесь 
ответственность: ответственности 
песня: песня песне песни 
пожелание: пожелания 
называться: назывался 
нэта: нэта 
конфиденциальность: конфиденциальности 
кокуриный: кокурина 
несоответствие: несоответствия 
материал: материалов 
роль: роль 
немецкий: немецкие 
авторский: авторские 
представить: представлена 
реклама: рекламы рекламу 
подписка: подписки 
вилара: вилар 
исполнение: исполнении 
французский: французские 
пожалуйста: пожалуйста 
разместить: разместить 
кубинец: кубинца 
поблагодарить: поблагодарить 
предоставляться: предоставляются 
некоторый: некоторые 
замечание: замечания 
отчаяние: отчаянии 
время: время 
обратный: обратная 
копирование: копирования 
он: нём 
игра: игра 
добавить: добавить 
соглашение: соглашение 
ради: ради 
отправить: отправить 
мочь: могут 
саундтрек: саундтрек 
войти: вошла 
отвечать: отвечаешь 
партнёрский: партнерская 
настроение: настроение 
спрашивать: спрашиваю 
страница: страница 
ошибка: ошибки 
представиться: представьтесь 
поддержать: поддержи 
треклист: треклист 
любимый: любимые 
пользовательский: пользовательское 
социальный: социальные 
сообщить: сообщите 
мы: нам 
согласовывать: согласовывайте 
проходить: проходят 
угадать: угадай 
программа: программа 
освальдо: освальдо 
