связь: связь 
автор: автор авторы авторами авторам 
атаковать: атакует 
общение: общение 
перевод: переводов переводу перевода переводы перевод 
умтити: умтити 
год: году лет 
вперёд: вперед 
рейтинг: рейтинг 
текст: текст 
домой: домой 
толиссо: толиссо 
кубок: кубок 
пенальти: пенальти 
дидье: дидье 
видеоклип: видеоклипы видеоклип 
испанский: испанские 
загрузка: загрузка 
отказ: отказ 
политика: политика 
варан: варан 
интересный: интересное 
форум: форум форуме 
принадлежать: принадлежат 
надёжный: надежен 
возможный: возможны 
менди: менди 
справа: справа 
выйти: выйти 
поль: поль 
понравиться: понравился понравиться 
мбапп: мбаппе 
радио: радио 
позвать: позвать 
популярный: популярные 
сеть: сети 
льорис: льорис 
контролировать: контролирует 
право: права 
набир: набир 
наш: наши 
эрнандес: эрнандес 
сайт: сайтом сайт 
мероприятие: мероприятия 
ареоля: ареоля 
зонзи: зонзи 
дешам: дешам 
отбить: отбей 
мелодия: мелодию 
кант: канте 
нога: ногами 
звать: зовут 
клип: клипов 
левша: левша 
самюэль: самюэль 
возможность: возможность 
кирка: кирка 
чемпионат: чемпионате 
снова: снова 
двадцать: двадцать 
кот: кот 
ганьоа: ганьоа 
бенжамена: бенжамена 
хит: хит 
правша: правша 
голо: голо 
юг: юге 
усман: усман 
тег: тегам теги 
английский: английские 
рафаэль: рафаэль 
персональный: персональное 
паблик: паблик 
мой: мои 
итальянский: итальянские 
мнение: мнений 
атака: атаку 
ускорение: ускорение 
мир: мира 
главный: главная 
авторизируться: авторизируйтесь 
ответственность: ответственности 
кимпемба: кимпембе 
лемара: лемар 
пожелание: пожелания 
оливье: оливье 
далее: д 
конфиденциальность: конфиденциальности 
знать: знаю 
поле: поле 
фло: фло 
сидиб: сидибе 
несоответствие: несоответствия 
антуан: антуан 
материал: материалов 
жир: жиру 
вместе: вместе 
немецкий: немецкие 
погб: погба 
авторский: авторские 
песня: песне песни 
подписка: подписки 
спокойный: спокойны 
национальный: национальной 
привезти: привезите 
блёз: блезом 
оба: обеими 
французский: французские 
проброс: проброс 
пожалуйста: пожалуйста 
разместить: разместить 
спортивный: спортивные 
бить: бью 
маэстро: маэстро 
футболист: футболисты 
спустя: спустя 
дембель: дембеле 
поблагодарить: поблагодарить 
предоставляться: предоставляются 
перечисляться: перечисляются 
некоторый: некоторые 
момент: момент 
замечание: замечания 
кто: кем 
фекиль: фекиль 
обратный: обратная 
товен: товен 
копирование: копирования 
парад: парад 
манданда: манданда 
игра: игра 
манёвр: маневр 
добавить: добавить 
гризманна: гризманн 
защищать: защищает 
удар: удар 
н: н 
соглашение: соглашение 
отправить: отправить 
мочь: могут 
это: это 
блезть: блез 
большой: большое 
ивуар: ивуара 
павар: павар 
ведение: ведение 
партнёрский: партнерская 
сборная: сборной 
ошибка: ошибки 
франция: франции 
представиться: представьтесь 
поддержать: поддержи 
треклист: треклист 
любимый: любимые 
пользовательский: пользовательское 
синий: синие 
социальный: социальные 
город: город 
футбол: футболу 
стычка: стычка 
слева: слева 
прозвище: прозвищу 
настать: настал 
сообщить: сообщите 
мы: нам 
мяч: мяча 
согласовывать: согласовывайте 
реклама: рекламу 
рами: рами 
матюидти: матюиди 
килиан: килиан 
победить: победившие 
угадать: угадай 
том: тома 
программа: программа 
обманный: обманный 
центр: центр 
спасибо: спасибо 
