таки: таки 
ночь: ночи 
связь: связь 
автор: автор авторы авторами авторам 
знать: знает знать 
возлюбить: возлюбленная 
общение: общение 
перевод: переводов переводу перевода переводы перевод 
рейтинг: рейтинг 
сбежать: сбежала 
текст: текст 
домой: домой 
видеоклип: видеоклипы видеоклип 
испанский: испанские 
загрузка: загрузка 
отказ: отказ 
политика: политика 
интересный: интересное 
путь: пути 
форум: форум форуме 
принадлежать: принадлежат 
убежать: убежала 
возможный: возможны 
сезон: сезона 
выйти: выйти 
понравиться: понравился понравиться 
радио: радио 
популярный: популярные 
сеть: сети 
право: права 
наш: наши 
одинаково: одинаково 
обратно: обратно 
истекать: истекать истекаешь истекаем 
сайт: сайтом сайт 
мелодия: мелодию 
клип: клипов 
ох: ох 
подобно: подобно 
возможность: возможность 
холодный: холодная 
искать: ищу 
земля: землей 
растворить: растворён 
хит: хит 
призрак: призраку 
сериал: сериала 
тег: тегам 
английский: английские 
персональный: персональное 
паблик: паблик 
вчера: вчера 
мой: мои моей 
итальянский: итальянские 
кровь: кровью крови 
мнение: мнений 
охотник: охотники 
ты: тебе тобой 
главный: главная 
авторизируться: авторизируйтесь 
ответственность: ответственности 
песня: песня песне песни 
рождение: рождения 
пожелание: пожелания 
анна: анна 
конфиденциальность: конфиденциальности 
мост: мосты 
страшно: страшно 
страх: страх 
несоответствие: несоответствия 
материал: материалов 
возвращаться: возвращайся 
телевизионный: телевизионного 
вместе: вместе 
немецкий: немецкие 
авторский: авторские 
подписка: подписки 
хотеть: хочу 
быть: буду 
французский: французские 
пожалуйста: пожалуйста 
разместить: разместить 
плакать: плакать 
поблагодарить: поблагодарить 
предоставляться: предоставляются 
некоторый: некоторые 
замечание: замечания 
пусть: пусть 
обратный: обратная 
сжигать: сжигаю 
копирование: копирования 
парад: парад 
игра: игра 
вернуться: вернется вернись 
просто: просто 
добавить: добавить 
нужно: нужно 
вознести: вознесена 
звучать: звучит 
второй: второго 
донцов: донцова 
соглашение: соглашение 
скрываться: скрывается 
отправить: отправить 
мочь: могут 
это: это 
постель: постель 
высоко: высоко 
партнёрский: партнерская 
известно: известно 
останки: останки 
ошибка: ошибки 
представиться: представьтесь 
поддержать: поддержи 
треклист: треклист 
любимый: любимые 
пользовательский: пользовательское 
сумеречный: сумеречные 
социальный: социальные 
восемнадцатый: восемнадцатой 
событие: событие 
сообщить: сообщите 
мы: нам 
облако: облака 
согласовывать: согласовывайте 
реклама: рекламу 
американский: американского 
холодное: холодные 
угадать: угадай 
день: день 
программа: программа 
серия: серии 
