твой: твоей 
связь: связь 
война: войны 
автор: автор авторы авторами автора авторам 
сосуществовать: сосуществовали 
общение: общение 
перевод: переводов переводу перевода переводы перевод 
посуда: посуды 
рейтинг: рейтинг 
слишком: слишком 
текст: текст 
стихотворный: стихотворные 
парад: парада парад 
украсть: украла 
мирно: мирно 
видеоклип: видеоклипы видеоклип 
испанский: испанские 
загрузка: загрузка 
любить: люблю любишь 
отказ: отказ 
требовать: требовавшей 
интересный: интересное 
политика: политика 
форум: форум форуме 
каменный: каменном 
принадлежать: принадлежат 
маленький: маленькой 
юлия: юлия 
возможный: возможны 
выйти: выйти 
понравиться: понравился понравиться 
радио: радио 
популярный: популярные 
сеть: сети 
кинозвезда: кинозвезда 
право: права 
наш: наши 
секрет: секреты 
сайт: сайтом сайт 
хотеться: хотелось 
наверное: наверное 
слово: слова 
который: которая которым которые которых 
брат: брат 
мелодия: мелодию 
свой: своим свои 
мочь: могло могут 
мать: матерью 
фабиан: фабиан 
клип: клипов 
возможность: возможность 
тот: те ту 
другой: другие 
хит: хит 
лидер: лидеры 
тело: тел 
тег: тегам теги 
английский: английские 
персональный: персональное 
способ: способы 
паблик: паблик 
допустить: допустить 
сильно: сильно 
мой: мои 
итальянский: итальянские 
доверить: доверила 
мнение: мнений 
танцевать: танцуем 
тишина: тишине 
ты: тебе тобой 
главный: главная 
становиться: становился становилась 
авторизируться: авторизируйтесь 
помочь: помогло 
ответственность: ответственности 
пожелание: пожелания 
рядом: рядом 
конфиденциальность: конфиденциальности 
несоответствие: несоответствия 
материал: материалов 
существовать: существовали 
немецкий: немецкие 
авторский: авторские 
песня: песне песни 
подписка: подписки 
общий: общей 
битьё: битье 
быть: буду 
действительно: действительно 
французский: французские 
разумеется: разумеется 
пожалуйста: пожалуйста 
разместить: разместить 
улыбка: улыбки 
защищать: защищал 
мечта: мечты 
поблагодарить: поблагодарить 
решить: решила 
волк: волк 
предоставляться: предоставляются 
некоторый: некоторые 
замечание: замечания 
король: король 
кричать: кричать 
хранитель: хранителем 
являться: являюсь 
обратный: обратная 
безумец: безумец 
копирование: копирования 
окружать: окружал 
лара: лара 
тайный: тайным 
игра: игра 
кончиться: кончатся 
добавить: добавить 
смотреть: смотрел 
соглашение: соглашение 
тепло: теплом 
отправить: отправить 
защита: защиты 
партнёрский: партнерская 
страница: страница 
горький: горькой 
ошибка: ошибки 
представиться: представьтесь 
поддержать: поддержи 
треклист: треклист 
любимый: любимые 
расстаться: расстаться 
сатана: сатана 
пользовательский: пользовательское 
социальный: социальные 
мужчина: мужчина 
сообщить: сообщите 
мы: нам 
простить: простить 
кровь: кровь крови 
дом: доме 
оиа: оиа 
литературный: литературные 
согласовывать: согласовывайте 
девочка: девочкой 
реклама: рекламу 
вариант: вариант 
видеть: видишь 
угадать: угадай 
солдат: солдат 
программа: программа 
