время: времён 
петь: петь 
связь: связь 
нога: ног 
автор: автор авторы авторами автора авторам 
место: место 
список: списке 
общение: общение 
перевод: переводов переводу перевода переводы перевод 
грррыы: грррыыы 
год: году года 
великий: величайших 
рейтинг: рейтинг 
текст: текст 
позвать: позови 
домой: домой 
написать: написана 
мужской: мужское 
определять: определяющих 
один: одну одной 
сбивать: сбиваешь 
видеоклип: видеоклипы видеоклип 
сказать: скажу скажи 
испанский: испанские 
загрузка: загрузка 
отказ: отказ 
политика: политика 
интересный: интересное 
пойти: пошел 
форум: форум форуме 
принадлежать: принадлежат 
пока: пока 
улыбка: улыбку 
возможный: возможны 
такой: таких 
рыдать: рыдать 
робертс: робертс 
песня: песен песню песня песне песни 
красотка: красотка 
выйти: выйти 
остаться: останешься 
ай: ай 
понравиться: понравился понравиться 
радио: радио 
подарить: подари 
орбисон: орбисоном орбисон 
популярный: популярные 
ой: ой 
телекомпания: телекомпании 
сеть: сети 
удостоить: удостоен 
право: права 
наш: наши 
подождать: подожди 
номинация: номинации 
тик: тик 
сайт: сайтом сайт 
живой: живое 
заставлять: заставляй 
надеяться: надеяться 
мелодия: мелодию 
стать: стала 
выпустить: выпущенного 
завтра: завтра 
клип: клипов 
возможность: возможность 
сжалиться: сжалься 
постоять: постой 
музыкальный: музыкальной музыкальном 
видеть: вижу 
рок: рок 
хит: хит 
рой: роем рой 
простить: прости 
позиция: позицию 
парад: параде парад 
назвать: названа 
тег: тегам 
английский: английские 
персональный: персональное 
паблик: паблик 
известный: известного 
вчера: вчера 
глаз: глазам 
мой: мои 
итальянский: итальянские 
поп: поп 
мнение: мнений 
белый: белая 
главный: главная 
художественный: художественного 
авторизируться: авторизируйтесь 
ответственность: ответственности 
неделя: недели 
рождение: рождения 
одинокий: одинока 
пожелание: пожелания 
ричард: ричарда 
конфиденциальность: конфиденциальности 
гир: гира 
несоответствие: несоответствия 
материал: материалов 
словно: словно 
мочь: мог могут 
ночь: ночь 
немецкий: немецкие 
авторский: авторские 
верить: верю 
журнал: журнал 
подписка: подписки 
я: мной 
уделить: удели 
передача: передаче 
пять: пять 
название: названием 
билл: биллом 
французский: французские 
лишь: лишь 
состав: состав 
поместить: поместил 
пожалуйста: пожалуйста 
разместить: разместить 
знак: знаком 
минута: минут 
поблагодарить: поблагодарить 
посмертно: посмертно 
предоставляться: предоставляются 
покидать: покидай 
некоторый: некоторые 
замечание: замечания 
эй: эй 
ты: тобой 
премия: премии 
музыка: музыку 
г: г 
чёрно: чёрно 
джулия: джулии 
обратный: обратная 
копирование: копирования 
асфальт: асфальту 
нервный: нервный 
игра: игра 
хороший: лучшее 
широко: широко 
давать: давай 
август: августе 
красота: красотой 
сон: сон 
добавить: добавить 
альбом: альбома 
диз: дизом 
занимать: занимала 
стучать: стучит 
н: н 
возвращаться: возвращается 
соглашение: соглашение 
отправить: отправить 
фильм: фильма 
войти: вошла 
каблучок: каблучком 
партнёрский: партнерская 
страница: страница 
ошибка: ошибки 
представиться: представьтесь 
судьба: судьба 
поддержать: поддержи 
треклист: треклист 
участие: участием 
любимый: любимые 
пользовательский: пользовательское 
социальный: социальные 
событие: событие 
вокальный: вокальное 
сообщить: сообщите 
ролл: ролл 
мы: нам 
впадать: впадаю 
согласовывать: согласовывайте 
исполнение: исполнение 
реклама: рекламу 
взглянуть: взгляни 
убегать: убегай 
грэмми: грэмми 
угадать: угадай 
нужный: нужна 
друг: друзья 
день: день 
программа: программа 
