рождество: рождество 
связь: связь 
автор: автор авторы авторами автора авторам 
пляж: пляжах 
общение: общение 
перевод: переводов переводу перевода переводы перевод 
ваш: ваш 
вечеринка: вечеринка 
рейтинг: рейтинг 
скакать: скачут 
текст: текст 
испанский: испанские 
загрузка: загрузка 
политика: политика 
громко: громко 
интересный: интересное 
форум: форум форуме 
принадлежать: принадлежат 
тревога: тревога 
вверх: вверх 
формат: формате 
выйти: выйти 
понравиться: понравился понравиться 
радио: радио 
популярный: популярные 
сеть: сети 
загрузить: загружено загрузить 
право: права 
наш: наши 
хххххха: хххххх 
детский: детские 
прыгать: прыгаем прыгают 
больший: большие 
мелодия: мелодию 
верно: верно 
поём: поём 
возможность: возможность 
вниз: вниз 
снова: снова 
ритм: ритм 
хит: хит 
видео: видео 
сайт: сайт 
тег: тегам теги 
английский: английские 
персональный: персональное 
секунда: секунд 
зайчик: зайчики зайчиков 
паблик: паблик 
указать: укажите указать 
мой: мои 
итальянский: итальянские 
мнение: мнений 
алексей: алексей 
лапка: лапки 
главный: главная 
авторизируться: авторизируйтесь 
пожелание: пожелания 
ритмично: ритмично 
отбивать: отбивают 
конфиденциальность: конфиденциальности 
материал: материалов 
несколько: несколько 
немецкий: немецкие 
авторский: авторские 
песня: песне песни 
подписка: подписки 
макушка: макушке 
перезагрузиться: перезагрузится 
другой: другое 
петь: поют 
танцевать: танцуют 
найти: найти 
французский: французские 
пожалуйста: пожалуйста 
разместить: разместить 
ухо: уши 
ссылка: ссылку 
год: год 
поблагодарить: поблагодарить 
песенка: песенку 
замечание: замечания 
обратный: обратная 
луг: лугах 
копирование: копирования 
парад: парад 
заячий: заячья 
игра: игра 
добавить: добавить 
шнуффель: шнуффель шнуффеля 
соглашение: соглашение 
отправить: отправить 
сюда: сюда 
мочь: могут 
это: это 
жижин: жижин 
задорно: задорно 
партнёрский: партнерская 
страница: страница 
всё: всё 
раскачиваться: раскачиваются 
ошибка: ошибки 
представиться: представьтесь 
поддержать: поддержи 
треклист: треклист 
любимый: любимые 
пользовательский: пользовательское 
социальный: социальные 
издалёка: издалека 
сообщить: сообщите 
ушко: ушки 
мы: нам 
новый: новый новым 
согласовывать: согласовывайте 
реклама: рекламу 
сегодня: сегодня 
угадать: угадай 
программа: программа 
спасибо: спасибо 
