связь: связь 
ночь: ночи 
автор: автор авторы авторами автора авторам 
знать: знает знаешь 
общение: общение 
перевод: переводов переводу перевода переводы перевод 
мочь: можешь мог могут 
свой: своих свой 
рейтинг: рейтинг 
узнать: узнала 
лезть: лезь 
текст: текст 
видеоклип: видеоклипы видеоклип 
испанский: испанские 
загрузка: загрузка 
отказ: отказ 
выгнать: выгнала 
интересный: интересное 
нечестивый: нечестивое 
политика: политика 
форум: форум форуме 
принадлежать: принадлежат 
пока: пока 
возможный: возможны 
слышать: слышу 
деньга: деньги 
выйти: выйти вышла 
понравиться: понравился понравиться 
радио: радио 
популярный: популярные 
смит: смит 
сеть: сети 
устраивать: устраиваю 
право: права 
кой: кое 
наш: наши 
такой: такого 
упаковать: упаковать 
сайт: сайтом сайт 
дать: дай 
любовь: любовь 
мелодия: мелодию 
ребёнок: детей 
баленсиаг: баленсиага 
клип: клипов 
человек: люди 
возможность: возможность 
оставить: оставил 
диван: диване 
который: которую которых 
хит: хит 
малыш: малыш 
одеяло: одеяло 
тег: тегам теги 
английский: английские 
звонить: звонит 
персональный: персональное 
папочка: папочка 
говорить: говорят говоришь 
паблик: паблик 
весь: всей 
расстёгивать: расстёгивает 
мой: мои 
итальянский: итальянские 
посреди: посреди 
мнение: мнений 
хрень: хрени 
дрочить: дрочит 
шептать: шепчут 
ты: тебе 
главный: главная 
побывать: побывал 
бордель: борделе 
авторизируться: авторизируйтесь 
мальчик: мальчик 
след: следы 
ответственность: ответственности 
пожелание: пожелания 
потрахаться: потрахаться 
конфиденциальность: конфиденциальности 
несоответствие: несоответствия 
материал: материалов 
тратить: трачу 
грязный: грязный 
немецкий: немецкие 
авторский: авторские 
песня: песне песни 
подписка: подписки 
ким: ким 
ома: ома 
заместить: замести 
откинуться: откинулся 
прикроить: прикрою 
смотреть: смотреть 
исполнение: исполнении 
французский: французские 
о: обо 
пожалуйста: пожалуйста 
разместить: разместить 
родео: родео 
петрас: петрас 
поблагодарить: поблагодарить 
хотеть: хочешь 
предоставляться: предоставляются 
сэм: сэм 
некоторый: некоторые 
замечание: замечания 
обратный: обратная 
копирование: копирования 
замуж: замуж 
парад: парад 
везучий: везучая 
давать: даёт 
дарить: дарит 
возбуждаться: возбуждается 
восседать: восседаю 
драма: драму 
просто: просто 
игра: игра 
добавить: добавить 
адресок: адресок 
нужно: нужно 
соглашение: соглашение 
отправить: отправить 
это: это 
партнёрский: партнерская 
прада: прада 
страница: страница 
фенди: фенди 
ошибка: ошибки 
представиться: представьтесь 
мамочка: мамочка 
хотеться: хочется 
треклист: треклист 
любимый: любимые 
поддержать: поддержи 
пользовательский: пользовательское 
социальный: социальные 
постоянно: постоянно 
сообщить: сообщите 
мы: нам 
штаны: штаны 
рианна: рианны 
согласовывать: согласовывайте 
место: местах 
девчонка: девчонка 
реклама: рекламу 
должный: должен 
делать: делая 
грэмми: грэмми 
угадать: угадай 
мм: мм 
программа: программа 
