полоска: полоску 
связь: связь 
смешаться: смешаемся 
белые: белые 
автор: автор авторы авторами автора авторам 
сила: сил 
общение: общение 
перевод: переводов переводу перевода переводы перевод 
узкий: узкие 
рейтинг: рейтинг 
модно: модно 
текст: текст 
преуспевать: преуспевающих 
пойти: пойдем пойти 
видеоклип: видеоклипы видеоклип 
испанский: испанские 
загрузка: загрузка 
отказ: отказ 
политика: политика 
интересный: интересное 
купер: купер 
форум: форум форуме 
принадлежать: принадлежат 
возможный: возможны 
брюки: брюки 
магазин: магазин 
миллион: миллион 
этот: этому 
выйти: выйти 
пальто: пальто 
понравиться: понравился понравиться 
радио: радио 
красивый: красивую 
популярный: популярные 
цилиндр: цилиндры 
сеть: сети 
разрез: разрезом 
право: права 
наш: наши 
супер: супер 
мода: моды 
авеню: авеню 
олег: олег 
сайт: сайтом сайт 
пытаться: пытаюсь 
бульвар: бульвару 
доллар: долларов 
мелодия: мелодию 
знать: знаешь 
одеваться: одеваясь 
сидеть: сидящее 
тип: типы 
клип: клипов 
высокий: высокие 
стоящий: стоящий 
возможность: возможность 
зонтик: зонтиками 
носка: носки 
лобачев: лобачев 
хит: хит 
трость: тростью 
тег: тегам теги 
английский: английские 
персональный: персональное 
паблик: паблик 
мой: мои 
итальянский: итальянские 
эквиритмический: эквиритмические 
мнение: мнений 
гулять: гуляют 
очень: очень 
ты: тебе 
главный: главная 
жизнь: жизнь 
авторизируться: авторизируйтесь 
ответственность: ответственности 
пожелание: пожелания 
конфиденциальность: конфиденциальности 
несоответствие: несоответствия 
материал: материалов 
монета: монету 
немецкий: немецкие 
авторский: авторские 
песня: песне песни 
прекрасно: прекрасно 
подписка: подписки 
каждый: каждую 
разный: разные 
французский: французские 
нос: носами 
пожалуйста: пожалуйста 
грустно: грустно 
разместить: разместить 
поблагодарить: поблагодарить 
который: которые 
актёр: актер 
почему: почему 
предоставляться: предоставляются 
некоторый: некоторые 
замечание: замечания 
задрать: задранными 
человек: людей 
обратный: обратная 
копирование: копирования 
парад: парад 
игра: игра 
из: изо 
просто: просто 
добавить: добавить 
перчатка: перчатках 
соглашение: соглашение 
одетый: одетые одет 
отправить: отправить 
воротник: воротники 
сюда: сюда 
мочь: могут 
гэри: гэри 
знаменитый: знаменитому 
партнёрский: партнерская 
страница: страница 
ошибка: ошибки 
представиться: представьтесь 
поддержать: поддержи 
треклист: треклист 
любимый: любимые 
парк: парк 
туда: туда 
пользовательский: пользовательское 
социальный: социальные 
надевать: надевают 
рокфеллер: рокфеллерами 
сообщить: сообщите 
мы: нам 
выглядеть: выглядеть 
тратить: тратят 
согласовывать: согласовывайте 
реклама: рекламу 
вариант: вариант 
угадать: угадай 
одеться: одеться 
программа: программа 
видеть: видел 
сновать: снующих 
