связь: связь 
автор: автор авторы авторами автора авторам 
знать: знает 
организовать: организовать 
общение: общение 
перевод: переводов переводу перевода переводы перевод 
сражаться: сражаться 
рейтинг: рейтинг 
текст: текст 
семь: семь семи 
видеоклип: видеоклипы видеоклип 
испанский: испанские 
загрузка: загрузка 
идти: идем 
отказ: отказ 
интересный: интересное 
политика: политика 
форум: форум форуме 
принадлежать: принадлежат 
возможный: возможны 
выйти: выйти 
никакой: никакой 
держаться: держаться 
понравиться: понравился понравиться 
радио: радио 
популярный: популярные 
сеть: сети 
право: права 
биться: биться 
наш: наши 
сайт: сайтом сайт 
справиться: справимся 
быть: будем 
мелодия: мелодию 
б: б 
клип: клипов 
возможность: возможность 
подойти: подойди 
неудача: неудача 
хит: хит 
жажда: жажда 
тег: тегам 
английский: английские 
принуждение: принуждения 
персональный: персональное 
паблик: паблик 
мой: мои 
итальянский: итальянские 
мнение: мнений 
хватить: хватит 
екатерина: екатерина 
главный: главная 
авторизируться: авторизируйтесь 
катиться: катится 
ответственность: ответственности 
пожелание: пожелания 
бочка: бочка 
должный: должны 
конфиденциальность: конфиденциальности 
одиночка: одиночку 
несоответствие: несоответствия 
материал: материалов 
вместе: вместе 
немецкий: немецкие 
никто: никто 
песня: песне песни 
авторский: авторские 
подписка: подписки 
пить: пьем пить 
французский: французские 
протяжение: протяжении 
пожалуйста: пожалуйста 
разместить: разместить 
поблагодарить: поблагодарить 
предоставляться: предоставляются 
некоторый: некоторые 
народный: народные 
замечание: замечания 
один: одному 
обратный: обратная 
копирование: копирования 
парад: парад 
игра: игра 
добавить: добавить 
взять: возьми 
жизнь: жизни 
хотеть: хотим 
врасплох: врасплох 
рутина: рутины 
ради: ради 
соглашение: соглашение 
отправить: отправить 
мочь: могут 
это: это 
партнёрский: партнерская 
страница: страница 
ошибка: ошибки 
представиться: представьтесь 
поддержать: поддержи 
треклист: треклист 
любимый: любимые 
пользовательский: пользовательское 
социальный: социальные 
долго: долго 
сообщить: сообщите 
день: дней 
мы: нам 
застать: застанет 
согласовывать: согласовывайте 
реклама: рекламу 
угадать: угадай 
программа: программа 
