связь: связь 
автор: автор авторы авторами автора авторам 
давать: давайте 
общение: общение 
перевод: переводов переводу перевода переводы перевод 
рука: руками 
случай: случае 
слишком: слишком 
откровенный: откровенна 
рейтинг: рейтинг 
текст: текст 
чистый: чистой 
откроить: открою 
хороший: хорошего хорошие 
стихотворный: стихотворные 
парад: парада парад 
видеоклип: видеоклипы видеоклип 
испанский: испанские 
загрузка: загрузка 
добро: добро 
небольшой: небольшой 
громко: громко 
отказ: отказ 
интересный: интересное 
политика: политика 
форум: форум форуме 
принадлежать: принадлежат 
такой: такая таком 
возможный: возможны 
деньга: деньги 
сваливать: сваливаю 
выйти: выйти 
понравиться: понравился понравиться 
радио: радио 
популярный: популярные 
совесть: совестью 
сеть: сети 
право: права 
наш: наши 
драгоценность: драгоценности 
сердиться: сержусь 
сайт: сайтом сайт 
мелодия: мелодию 
невшатель: невшатель 
забыть: забудьте 
полина: полина 
клип: клипов клип 
возможность: возможность 
гранд: гранд 
свобода: свободу 
персонал: персонал 
эйфелев: эйфелеву 
хит: хит 
папалапапап: папалапапапа 
лидер: лидеры 
шаблонный: шаблонные 
тег: тегам теги 
английский: английские 
персональный: персональное 
паблик: паблик 
вчера: вчера 
мой: мои мою 
итальянский: итальянские 
эквиритмический: эквиритмические 
слышать: слышать 
мнение: мнений 
лицемерие: лицемерие 
песня: песню песне песни 
дать: дайте 
лимузин: лимузин 
радость: радости 
главный: главная 
есть: ем 
авторизируться: авторизируйтесь 
кирилл: кирилл 
ответственность: ответственности 
рождение: рождения 
пожелание: пожелания 
конфиденциальность: конфиденциальности 
ритц: ритц 
несоответствие: несоответствия 
материал: материалов 
шанель: шанель 
тюрнина: тюрнина 
немецкий: немецкие 
любовь: любви 
авторский: авторские 
подписка: подписки 
хотеть: хочу 
замок: замок 
надоесть: надоели надоело 
настроение: настроения 
открыть: откроем 
французский: французские 
пожалуйста: пожалуйста 
разместить: разместить 
манера: манеры 
ваш: ваши 
пожаловать: пожаловать 
извинить: извините 
екатеринбург: екатеринбург 
поблагодарить: поблагодарить 
умереть: умереть 
предоставляться: предоставляются 
любой: любом 
некоторый: некоторые 
замечание: замечания 
башня: башню 
люкс: люкс 
подарить: подарите 
обратный: обратная 
реальность: реальность 
копирование: копирования 
номер: номер 
игра: игра 
осчастливить: осчастливят 
добавить: добавить 
соглашение: соглашение 
отправить: отправить 
мочь: могут 
конченый: кончено 
это: это 
стереотип: стереотипы 
отель: отеле 
посмотреть: посмотрите 
речь: речи 
алай: алая 
партнёрский: партнерская 
страница: страница 
логин: логин 
ошибка: ошибки 
представиться: представьтесь 
поддержать: поддержи 
хотеться: хочется 
треклист: треклист 
любимый: любимые 
клюев: клюев 
пользовательский: пользовательское 
делать: делать 
социальный: социальные 
событие: событие 
сообщить: сообщите 
мы: нам 
алла: алла 
отсюда: отсюда 
литературный: литературные 
согласовывать: согласовывайте 
реклама: рекламу 
говорить: говорю 
вариант: вариант 
угадать: угадай 
день: день 
программа: программа 
