связь: связь 
мысль: мысли 
место: место 
автор: автор авторы авторами авторам 
общение: общение 
перевод: переводов переводу перевода переводы перевод 
дословно: дословно 
рейтинг: рейтинг 
текст: текст 
домой: домой 
парад: парада парад 
видеоклип: видеоклипы видеоклип 
испанский: испанские 
загрузка: загрузка 
добро: добро 
кость: кости 
отказ: отказ 
интересный: интересное 
сотня: сотню 
политика: политика 
надеяться: надеюсь 
форум: форум форуме 
принадлежать: принадлежат 
кусок: куски 
возможный: возможны 
такой: таких 
выйти: выйти 
понравиться: понравился понравиться 
радио: радио 
твёрдый: твердый 
популярный: популярные 
сеть: сети 
сделать: сделано 
исчезнуть: исчезнешь 
право: права 
наш: наши 
выход: выход 
сайт: сайтом сайт 
здравствуй: здравствуй 
живой: живой живым 
замечательный: замечательно 
мелодия: мелодию 
поиск: поиске 
занять: заняло займет 
клип: клипов 
ох: ох 
мой: моем мои 
возможность: возможность 
остаться: остаться остались 
один: одной 
сердце: сердце 
хит: хит 
побороть: побороть 
лидер: лидеры 
тег: тегам теги 
английский: английские 
персональный: персональное 
паблик: паблик 
хрупкий: хрупкое 
итальянский: итальянские 
должный: должна 
мнение: мнений 
хороший: получше 
однажды: однажды 
главный: главная 
авторизируться: авторизируйтесь 
свой: свой 
ответственность: ответственности 
пожелание: пожелания 
год: лет 
конфиденциальность: конфиденциальности 
разум: разуме разум 
знать: знаю 
страх: страх 
несоответствие: несоответствия 
материал: материалов 
ночь: ночь 
немецкий: немецкие 
авторский: авторские 
песня: песне песни 
подписка: подписки 
хотеть: хочу 
вблизи: вблизи 
почувствовать: почувствовать 
найти: найти нашла 
кожа: кожа 
исполнение: исполнении 
французский: французские 
лишь: лишь 
мочь: могу могут 
пожалуйста: пожалуйста 
разместить: разместить 
пожаловать: пожаловать 
местечко: местечка 
поблагодарить: поблагодарить 
предоставляться: предоставляются 
некоторый: некоторые 
замечание: замечания 
время: время 
обратный: обратная 
копирование: копирования 
спрятаться: спрятаться 
игра: игра 
добавить: добавить 
нужно: нужно 
выбраться: выберусь 
соглашение: соглашение 
камень: камня 
снаружи: снаружи 
отправить: отправить 
пожалуй: пожалуй 
это: это 
думать: думала 
партнёрский: партнерская 
покидать: покидаю 
ошибка: ошибки 
представиться: представьтесь 
поддержать: поддержи 
треклист: треклист 
любимый: любимые 
пользовательский: пользовательское 
никак: никак 
социальный: социальные 
сообщить: сообщите 
мы: нам 
отсюда: отсюда 
согласовывать: согласовывайте 
разорвать: разорви 
навсегда: навсегда 
реклама: рекламу 
вариант: вариант 
угадать: угадай 
стекло: стекла 
айлиш: айлиш 
программа: программа 
билли: билли 
