связь: связь 
автор: автор авторы авторами авторам 
общение: общение 
перевод: переводов переводу перевода переводы перевод 
рейтинг: рейтинг 
околдовывать: околдовывает 
пьяный: пьян 
текст: текст 
стихотворный: стихотворные 
парад: парада парад 
видеоклип: видеоклипы видеоклип 
испанский: испанские 
загрузка: загрузка 
отказ: отказ 
политика: политика 
интересный: интересное 
форум: форум форуме 
принадлежать: принадлежат 
возможный: возможны 
выйти: выйти 
понравиться: понравился понравиться 
радио: радио 
популярный: популярные 
красивый: красивая 
сеть: сети 
право: права 
наш: наши 
искусство: искусств 
чистый: чистый 
сайт: сайтом сайт 
мелодия: мелодию 
любим: любим 
люсиль: люсиль 
клип: клипов 
возможность: возможность 
сено: сена 
сцена: сцене 
луна: луна 
хит: хит 
сердце: сердце 
лидер: лидеры 
хороший: хорош 
тег: тегам теги 
английский: английские 
трепетать: трепещет 
персональный: персональное 
паблик: паблик 
вчера: вчера 
мой: мои мое 
итальянский: итальянские 
мнение: мнений 
уверенный: уверенная 
очень: очень 
главный: главная 
авторизируться: авторизируйтесь 
ответственность: ответственности 
рождение: рождения 
пожелание: пожелания 
конфиденциальность: конфиденциальности 
знать: знаю 
несоответствие: несоответствия 
материал: материалов 
немецкий: немецкие 
друг: друга друг 
образ: образе 
песня: песне песни 
авторский: авторские 
подписка: подписки 
французский: французские 
пожалуйста: пожалуйста 
разместить: разместить 
поблагодарить: поблагодарить 
почему: почему 
предоставляться: предоставляются 
абсолютно: абсолютно 
ясный: ясная 
замечание: замечания 
некоторый: некоторые 
сена: сеной 
воздух: воздух 
обратный: обратная 
копирование: копирования 
игра: игра 
монстр: монстр 
добавить: добавить 
соглашение: соглашение 
отправить: отправить 
экстра: экстра 
мочь: могут 
это: это 
вода: вод 
тень: тени 
партнёрский: партнерская 
вдыхать: вдыхаю 
ангела: ангела 
ошибка: ошибки 
представиться: представьтесь 
поддержать: поддержи 
треклист: треклист 
любимый: любимые 
пользовательский: пользовательское 
выступать: выступает 
социальный: социальные 
париж: париж париже 
событие: событие 
сообщить: сообщите 
мы: нам 
литературный: литературные 
елена: елена 
согласовывать: согласовывайте 
реклама: рекламу 
экстравагантный: экстравагантна 
вариант: вариант 
мост: мосту 
угадать: угадай 
день: день 
выходить: выходит 
берег: берегов 
программа: программа 
