натурал: натуралом натурала 
сердце: сердца 
связь: связь 
проходить: прохожу 
автор: автор авторы авторами автора авторам 
общение: общение 
перевод: переводов переводу перевода переводы перевод 
либидо: либидо 
дословно: дословно 
мужчина: мужчину 
ветер: ветру 
рейтинг: рейтинг 
текст: текст 
дословный: дословная 
петух: петух 
лететь: летит 
унция: унций 
видеоклип: видеоклипы видеоклип 
секс: сексу 
сказать: скажу 
испанский: испанские 
загрузка: загрузка 
отказ: отказ 
кость: кости 
интересный: интересное 
труба: труба 
политика: политика 
форум: форум форуме 
принадлежать: принадлежат 
остановка: остановкой 
возможный: возможны 
нейтральный: нейтральное 
аналог: аналог 
выйти: выйти 
понравиться: понравился понравиться понравится 
смешно: смешно 
радио: радио 
популярный: популярные 
сеть: сети 
надевать: надеваю 
пит: питом пит 
право: права 
наш: наши 
бельё: белье 
сайт: сайтом сайт 
стейк: стейк 
никакой: никаких 
мелодия: мелодию 
клип: клипов 
человек: люди 
нездоровый: нездоровых 
возможность: возможность 
термин: термину 
который: который которого 
игрок: игрок 
каждый: каждый 
видеть: вижу 
хит: хит 
умирать: умирают 
тег: тегам 
английский: английские английское 
ебучего: ебучего 
утром: утром 
персональный: персональное 
паблик: паблик 
окно: окон 
сильно: сильно 
вчера: вчера 
мой: мои мое 
итальянский: итальянские 
девушка: девушка 
мнение: мнений 
женский: женское 
также: также 
ты: тебе 
главный: главная 
боксёр: боксеры 
авторизируться: авторизируйтесь 
ответственность: ответственности 
рождение: рождения 
пожелание: пожелания 
переходить: переходит 
позировать: позирую 
бейсбол: бейсбол 
рядом: рядом 
применяться: применяется 
ликование: ликований 
конфиденциальность: конфиденциальности 
день: днем день 
несоответствие: несоответствия 
материал: материалов 
жить: живу 
клясться: клянусь 
немецкий: немецкие 
скрещивать: скрещиваю 
неприятный: неприятное 
слэнговый: слэнговое 
песня: песне песни 
авторский: авторские 
подписка: подписки 
я: мной 
усмирить: усмири 
правда: правды 
затем: затем 
действительно: действительно 
французский: французские 
отсылать: отсылать 
мочь: могу могут 
пожалуйста: пожалуйста 
разместить: разместить 
плевать: плевать 
бог: бога бог 
дымовой: дымовая 
поблагодарить: поблагодарить 
заменяться: заменяется 
предоставляться: предоставляются 
некоторый: некоторые 
замечание: замечания 
возраст: возраста 
фаллический: фаллический 
выражение: выражение 
описывать: описывающему 
обратный: обратная 
вихрь: вихрь 
копирование: копирования 
парад: парад 
женщина: женщина 
любить: любит 
игра: игра 
голый: голая 
больница: больницы 
делать: делает 
добавить: добавить 
самец: самец 
нужно: нужно 
зеркало: зеркала 
соглашение: соглашение 
ради: ради 
нога: ноги 
отправить: отправить 
это: это 
думать: думала 
партнёрский: партнерская 
меняться: меняется 
японский: японскому 
инфаркт: инфаркт 
страница: страница 
приглашение: приглашений 
всё: всё 
хоум: хоум 
ошибка: ошибки 
безразличный: безразличных 
шлёпать: шлепать 
представиться: представьтесь 
треклист: треклист 
поддержать: поддержи 
любимый: любимые 
рана: рану 
большой: большого 
квира: квир 
пользовательский: пользовательское 
социальный: социальные 
мимо: мимо 
печь: печь 
э: э 
событие: событие 
ябо: ябо 
сообщить: сообщите 
мы: нам 
юный: юного 
согласовывать: согласовывайте 
обтягивать: обтягивающие 
утешить: утешить 
слово: слово 
реклама: рекламу 
напротив: напротив 
символ: символ 
больничный: больничная 
угадать: угадай 
программа: программа 
