связь: связь 
автор: автор авторы авторами автора авторам 
общение: общение 
перевод: переводов переводу перевода переводы перевод 
многие: многие 
рейтинг: рейтинг 
л: л 
текст: текст 
едва: едва 
видеоклип: видеоклипы видеоклип 
испанский: испанские 
загрузка: загрузка 
любить: люблю 
отказ: отказ 
интересный: интересное 
политика: политика 
форум: форум форуме 
принадлежать: принадлежат 
красный: красном 
прекрасный: прекрасной прекрасна 
возможный: возможны 
выйти: выйти 
понравиться: понравился понравиться 
часто: часто 
радио: радио 
танцевать: танцует танцевать 
популярный: популярные 
сеть: сети 
дискотека: дискотека 
право: права 
твой: твои 
наш: наши 
такой: такого 
сайт: сайтом сайт 
чувство: чувства 
лёгкий: легкий 
глаз: глаз 
мелодия: мелодию 
платье: платье 
клип: клипов 
возможность: возможность возможности 
щека: щеке щека 
забыть: забуду 
хит: хит 
ярко: ярко 
тег: тегам теги 
английский: английские 
персональный: персональное 
паблик: паблик 
мой: мои 
итальянский: итальянские 
волос: волосы 
мнение: мнений 
гармония: гармонии 
екатерина: екатерина 
приглашать: приглашали 
главный: главная 
улыбнуться: улыбнулась 
авторизируться: авторизируйтесь 
ответственность: ответственности 
пожелание: пожелания 
хотеть: хотят хочу хотели 
рядом: рядом 
выглядеть: выглядишь 
конфиденциальность: конфиденциальности 
повернуться: повернулась 
светлый: светлы 
знать: знаю 
несоответствие: несоответствия 
материал: материалов 
немецкий: немецкие 
любовь: любви 
песня: песне песни 
авторский: авторские 
подписка: подписки 
перехватить: перехватило 
я: мной 
любой: любой 
исполнение: исполнении 
французский: французские 
эффектный: эффектной 
пожалуйста: пожалуйста 
разместить: разместить 
х: х 
поблагодарить: поблагодарить 
роман: роман 
предоставляться: предоставляются 
некоторый: некоторые 
замечание: замечания 
ослепить: ослеплен 
ты: тобой 
обратный: обратная 
копирование: копирования 
парад: парад 
игра: игра 
вечером: вечером 
добавить: добавить 
кто: кого 
соглашение: соглашение 
отправить: отправить 
мочь: могут 
это: это 
сиять: сияющей 
замутить: замутить 
партнёрский: партнерская 
красавица: красавицу 
страница: страница 
леди: леди 
никто: никого 
ошибка: ошибки 
представиться: представьтесь 
поддержать: поддержи 
треклист: треклист 
любимый: любимые 
пользовательский: пользовательское 
оторвать: оторвать 
социальный: социальные 
настолько: настолько 
сообщить: сообщите 
мы: нам 
согласовывать: согласовывайте 
реклама: рекламу 
сегодня: сегодня 
дыхание: дыхание 
вариант: вариант 
угадать: угадай 
программа: программа 
видеть: видел 
к: ко 
