канада: канаде 
связь: связь 
автор: автор авторы авторами автора авторам 
постучать: постучал 
общение: общение 
перевод: переводов переводу перевода переводы перевод 
обслуживающий: обслуживающей 
мочь: можешь могут 
мужчина: мужчину 
рейтинг: рейтинг 
текст: текст 
пора: пора 
рано: рано 
испанский: испанские 
загрузка: загрузка 
политика: политика 
интересный: интересное 
форум: форум форуме 
искать: искать 
пока: пока 
принадлежать: принадлежат 
обочина: обочине 
дьявол: дьявол 
формат: формате 
выйти: выйти 
понравиться: понравился понравиться 
радио: радио 
популярный: популярные 
сеть: сети 
загрузить: загружено загрузить 
мой: моего мои моё мою 
право: права 
кавер: кавер 
наш: наши 
дверь: дверь 
хххххха: хххххх 
здравствуй: здравствуй 
идти: идти шли 
земля: земли 
мелодия: мелодию 
верно: верно 
человек: люди 
возможность: возможность 
хит: хит 
видео: видео 
сайт: сайт 
рука: руку рука 
автобус: автобус 
тег: тегам 
английский: английские 
персональный: персональное 
секунда: секунд 
утром: утром 
паблик: паблик 
преследовать: преследуют преследовать 
указать: укажите указать 
итальянский: итальянские 
мнение: мнений 
вчера: вчера 
песня: песню песне песни 
главный: главная 
авторизируться: авторизируйтесь 
остаться: останусь 
восстать: восставший 
рождение: рождения 
пожелание: пожелания 
тело: тело 
злой: злой 
конфиденциальность: конфиденциальности 
материал: материалов 
понять: поняла 
несколько: несколько 
немецкий: немецкие 
авторский: авторские 
сша: сша 
подписка: подписки 
перезагрузиться: перезагрузится 
сказать: сказала 
другой: другое 
быть: буду 
возможно: возможно 
понимать: понимаю 
найти: найти 
старый: старый 
французский: французские 
перевозка: перевозки 
пожалуйста: пожалуйста 
разместить: разместить 
ссылка: ссылку 
мексика: мексике 
поблагодарить: поблагодарить 
сесть: сесть 
почему: почему 
довольный: довольна 
похоронить: похоронить 
замечание: замечания 
компания: компании 
обратный: обратная 
копирование: копирования 
парад: парад 
отправиться: отправиться 
игра: игра 
путь: путь 
добавить: добавить 
междугородний: междугородние 
соглашение: соглашение 
отправить: отправить 
это: это 
партнёрский: партнерская 
страница: страница 
всё: всё 
ошибка: ошибки 
представиться: представьтесь 
поддержать: поддержи 
треклист: треклист 
любимый: любимые 
сатана: сатана 
пользовательский: пользовательское 
социальный: социальные 
событие: событие 
сообщить: сообщите 
дух: дух 
мы: нам 
согласовывать: согласовывайте 
новый: новым 
реклама: рекламу 
сегодня: сегодня 
угадать: угадай 
день: день 
программа: программа 
спасибо: спасибо 
