спидометр: спидометре 
связь: связь 
ужасно: ужасно 
автор: автор авторы авторами авторам 
скорость: скорости скорость 
красный: красное красная 
общение: общение 
перевод: переводов переводу перевода переводы перевод 
рейтинг: рейтинг 
текст: текст 
обряд: обряд 
видеоклип: видеоклипы видеоклип 
испанский: испанские 
загрузка: загрузка 
любить: люблю 
удовольствие: удовольствие 
отказ: отказ 
интересный: интересное 
политика: политика 
форум: форум форуме 
принадлежать: принадлежат 
легендарный: легендарное 
возможный: возможны 
классический: классический 
выйти: выйти 
понравиться: понравился понравиться 
радио: радио 
жар: жар 
популярный: популярные 
сеть: сети 
рассказать: рассказать 
право: права 
наш: наши 
секрет: секреты 
разгораться: разгорается 
сайт: сайтом сайт 
шумиха: шумихи 
скиталец: скиталец 
себя: собой 
мелодия: мелодию 
золотой: золотой 
гореть: горят 
клип: клипов 
наблюдать: наблюдаю 
возможность: возможность 
хит: хит 
грязь: грязь 
тег: тегам 
английский: английские 
персональный: персональное 
сильный: сильнее 
вена: вены 
паблик: паблик 
боль: боль 
край: краю 
мой: мои мое 
итальянский: итальянские 
огонь: огнем огонь 
нравиться: нравилось 
мнение: мнений 
пламя: пламя 
главный: главная 
авторизируться: авторизируйтесь 
безумный: безумен 
ответственность: ответственности 
пожелание: пожелания 
переходить: переходит 
конфиденциальность: конфиденциальности 
несоответствие: несоответствия 
максимальный: максимальные 
материал: материалов 
долбанатия: долбанатий 
играть: играть 
немецкий: немецкие 
взвод: взводе 
песня: песне песни 
авторский: авторские 
животное: животное 
подписка: подписки 
значение: значения 
оу: оу 
смотреть: смотреть 
французский: французские 
мочь: могу могут 
пожалуйста: пожалуйста 
разместить: разместить 
возбуждать: возбуждает 
поделать: поделать 
поблагодарить: поблагодарить 
который: которые 
ммм: ммм 
предоставляться: предоставляются 
некоторый: некоторые 
замечание: замечания 
бензин: бензина 
король: король 
спичка: спичка спичку 
обратный: обратная 
превращаться: превращается 
копирование: копирования 
парад: парад 
игра: игра 
зажигать: зажигаю 
отрицать: отрицаю 
королева: королева 
узнать: узнаешь 
горячий: горячая 
добавить: добавить 
полоса: полоса 
опасность: опасность 
неудержимый: неудержимое 
иметься: имеется 
соглашение: соглашение 
отправить: отправить 
еда: еду 
это: это 
внутри: внутри 
партнёрский: партнерская 
пепел: пепел 
ошибка: ошибки 
представиться: представьтесь 
поддержать: поддержи 
правосудие: правосудие 
треклист: треклист 
любимый: любимые 
пользовательский: пользовательское 
социальный: социальные 
здравствовать: здравствуют 
цифровой: цифровое 
сообщить: сообщите 
мы: нам 
кровь: кровь 
ощутить: ощутить 
запах: запах 
согласовывать: согласовывайте 
реклама: рекламу 
бензобак: бензобаке 
замок: замки 
вид: виду 
угадать: угадай 
программа: программа 
