твой: твоей 
связь: связь 
автор: автор авторы авторами авторам 
изменить: изменил 
общение: общение 
перевод: переводов переводу перевода переводы перевод 
сам: сами 
постель: постели 
рейтинг: рейтинг 
новый: новое 
текст: текст 
закончиться: закончиться 
рука: руки 
видеоклип: видеоклипы видеоклип 
достойный: достойнее 
испанский: испанские 
загрузка: загрузка 
другой: другую 
отказ: отказ 
интересный: интересное 
политика: политика 
форум: форум форуме 
принадлежать: принадлежат 
тупик: тупиком 
возможный: возможны 
свой: свое своей 
выйти: выйти 
устроить: устроил 
делать: делала 
понравиться: понравился понравиться 
радио: радио 
популярный: популярные 
сеть: сети 
право: права 
наш: наши 
позволять: позволяешь 
сайт: сайтом сайт 
тонуть: тонущего 
который: которая которую 
мелодия: мелодию 
жить: жить 
спокойно: спокойно 
клип: клипов 
позволить: позволю 
тикать: тикать 
возможность: возможность 
горевать: горевать 
ти: ти 
решение: решение 
хит: хит 
простить: прости 
поднимать: поднимаю 
тег: тегам 
английский: английские 
найти: найду 
персональный: персональное 
сильный: сильнее 
сбрасывать: сбрасываю 
паблик: паблик 
мой: мои 
итальянский: итальянские 
мнение: мнений 
передумать: передумал 
наповал: наповал 
главный: главная 
жизнь: жизнью жизни 
авторизируться: авторизируйтесь 
ответственность: ответственности 
пожелание: пожелания 
конфиденциальность: конфиденциальности 
мы: нами нам 
несоответствие: несоответствия 
материал: материалов 
сдаться: сдаться 
прыгать: прыгаю 
немецкий: немецкие 
авторский: авторские 
песня: песне песни 
подписка: подписки 
корабль: корабля 
думать: думаю думал 
быть: буду е 
продолжать: продолжают 
улица: улице 
французский: французские 
пожалуйста: пожалуйста 
разместить: разместить 
поблагодарить: поблагодарить 
повезти: повезло 
исчезнуть: исчезнуть 
предоставляться: предоставляются 
некоторый: некоторые 
замечание: замечания 
стелить: стелили 
эй: эй 
очередной: очередной 
обратный: обратная 
решить: решил 
копирование: копирования 
парад: парад 
заканчиваться: заканчивается 
игра: игра 
добавить: добавить 
простыня: простыни 
часы: часы 
закончить: закончить 
соглашение: соглашение 
отправить: отправить 
еда: еду 
мочь: могут 
конченый: кончено 
сразить: сражу 
начало: начало 
партнёрский: партнерская 
всё: всё 
ошибка: ошибки 
представиться: представьтесь 
поддержать: поддержи 
треклист: треклист 
любимый: любимые 
пользовательский: пользовательское 
социальный: социальные 
сообщить: сообщите 
согласовывать: согласовывайте 
реклама: рекламу 
бардак: бардак 
угадать: угадай 
программа: программа 
стерва: стерве 
