связь: связь 
автор: автор авторы авторами авторам 
общение: общение 
перевод: переводов переводу перевода переводы перевод 
лес: лес 
рейтинг: рейтинг 
текст: текст 
шаль: шаль 
видеоклип: видеоклипы видеоклип 
испанский: испанские 
загрузка: загрузка 
отказ: отказ 
политика: политика 
интересный: интересное 
форум: форум форуме 
принадлежать: принадлежат 
считать: считаю 
набрасывать: набрасывает 
возможный: возможны 
аналог: аналог 
лесной: лесной 
выйти: выйти 
понравиться: понравился понравиться 
радио: радио 
популярный: популярные 
сеть: сети 
право: права 
наш: наши 
сайт: сайтом сайт 
мелодия: мелодию 
жить: жить 
клип: клипов 
возможность: возможность 
последний: последний 
раммштайна: раммштайн 
одинокий: одинок 
трудно: трудно 
хит: хит 
земля: землю 
пустой: пустой 
тег: тегам 
английский: английские 
персональный: персональное 
паблик: паблик 
вчера: вчера 
мой: мои 
итальянский: итальянские 
мнение: мнений 
секунда: секунды 
главный: главная 
авторизируться: авторизируйтесь 
ответственность: ответственности 
рождение: рождения 
пожелание: пожелания 
иметь: имеют 
конфиденциальность: конфиденциальности 
безжизненно: безжизненно 
несоответствие: несоответствия 
материал: материалов 
немецкий: немецкие 
авторский: авторские 
песня: песне песни 
подписка: подписки 
петь: поют 
французский: французские 
дышать: дышать 
тёмный: тёмный 
мочь: могу могут 
пожалуйста: пожалуйста 
разместить: разместить 
пойти: пойду 
поблагодарить: поблагодарить 
останавливаться: останавливаются 
предоставляться: предоставляются 
тихо: тихо 
некоторый: некоторые 
замечание: замечания 
тропа: тропы 
ты: тобой 
обратный: обратная 
копирование: копирования 
парад: парад 
игра: игра 
добавить: добавить 
ветвь: ветвях 
птица: птицы 
смысл: смысла 
еловый: еловый 
вечер: вечер 
часы: часы 
соглашение: соглашение 
отправить: отправить 
говорить: говорить 
партнёрский: партнерская 
низина: низинах 
ах: ах 
ошибка: ошибки 
представиться: представьтесь 
поддержать: поддержи 
треклист: треклист 
любимый: любимые 
туда: туда 
пользовательский: пользовательское 
социальный: социальные 
её: её 
событие: событие 
сообщить: сообщите 
мы: нам 
больно: больно 
согласовывать: согласовывайте 
реклама: рекламу 
угадать: угадай 
день: день 
программа: программа 
видеть: видел 
опушка: опушкой 
