связь: связь 
взгляд: взгляда 
автор: автор авторы авторами автора авторам 
сила: сил силу 
общение: общение 
перевод: переводов переводу перевода переводы перевод 
увидеть: увидела 
рейтинг: рейтинг 
текст: текст 
единый: единым 
свет: света свет 
видеоклип: видеоклипы видеоклип 
испанский: испанские 
загрузка: загрузка 
отказ: отказ 
вселенная: вселенной 
интересный: интересное 
политика: политика 
форум: форум форуме 
принадлежать: принадлежат 
бриллиант: бриллиант бриллианты 
возможный: возможны 
полный: полные 
выйти: выйти 
ощутить: ощутила 
понравиться: понравился понравиться 
радио: радио 
популярный: популярные 
сеть: сети 
право: права 
наш: наши 
ладонь: ладони 
сайт: сайтом сайт 
мелодия: мелодию 
метеор: метеор 
умереть: умрем 
клип: клипов 
возможность: возможность 
прекрасный: прекрасны прекрасном 
видеть: вижу 
хит: хит 
обнимать: обнимаешь 
ярко: ярко 
тег: тегам 
английский: английские 
персональный: персональное 
паблик: паблик 
мой: мои 
итальянский: итальянские 
глаз: глаза глазах 
мнение: мнений 
обличие: обличье 
море: море 
главный: главная 
жизнь: жизнь 
авторизируться: авторизируйтесь 
излучать: излучаем 
ответственность: ответственности 
пожелание: пожелания 
конфиденциальность: конфиденциальности 
обратить: обращены 
несоответствие: несоответствия 
тепло: тепло 
материал: материалов 
словно: словно 
ночью: ночью 
немецкий: немецкие 
небо: небесах 
авторский: авторские 
песня: песне песни 
подписка: подписки 
первый: первого 
найти: найди 
солнечный: солнечного 
живой: жива 
французский: французские 
выбор: выбор 
пожалуйста: пожалуйста 
разместить: разместить 
сияние: сияние 
поблагодарить: поблагодарить 
предоставляться: предоставляются 
некоторый: некоторые 
замечание: замечания 
ты: тобой 
немедля: немедля 
обратный: обратная 
сразу: сразу 
копирование: копирования 
парад: парад 
игра: игра 
добавить: добавить 
знать: знала 
счастливый: счастливой 
твой: твоих 
соглашение: соглашение 
отправить: отправить 
мочь: могут 
восторг: восторг 
партнёрский: партнерская 
сиять: сияя сияй 
покуда: покуда 
лунный: лунный 
страница: страница 
ошибка: ошибки 
почувствовать: почувствуй 
представиться: представьтесь 
поддержать: поддержи 
треклист: треклист 
любимый: любимые 
пользовательский: пользовательское 
социальный: социальные 
сообщить: сообщите 
мы: нам 
стать: станем 
согласовывать: согласовывайте 
реклама: рекламу 
угадать: угадай 
программа: программа 
к: ко 
