связь: связь 
этот: эта 
автор: автор авторы авторами автора авторам 
общение: общение 
перевод: переводов переводу перевода переводы перевод 
рейтинг: рейтинг 
текст: текст 
цветок: цветка 
парад: парада парад 
видеоклип: видеоклипы видеоклип 
испанский: испанские 
загрузка: загрузка 
отказ: отказ 
политика: политика 
интересный: интересное 
форум: форум форуме 
принадлежать: принадлежат 
пока: пока 
возможный: возможны 
песня: песен песня песне песни 
красотка: красотка 
выйти: выйти 
понравиться: понравился понравиться 
радио: радио 
популярный: популярные 
сеть: сети 
чуять: чую 
окно: окно 
бой: бою 
право: права 
наш: наши 
похоронить: похороните 
смерть: смерть 
сайт: сайтом сайт 
павел: павел 
мелодия: мелодию 
клип: клипов 
возможность: возможность 
красный: красного 
прощать: прощай 
хит: хит 
лидер: лидеры 
враг: врага 
тег: тегам теги 
английский: английские 
проснуться: проснулся 
персональный: персональное 
утром: утром 
паблик: паблик 
вчера: вчера 
мой: мои 
итальянский: итальянские 
мнение: мнений 
коль: коль 
также: также 
главный: главная 
партизан: партизаны 
авторизируться: авторизируйтесь 
ответственность: ответственности 
магомаев: магомаев 
пожелание: пожелания 
рождение: рождения 
конфиденциальность: конфиденциальности 
несоответствие: несоответствия 
материал: материалов 
немецкий: немецкие 
авторский: авторские 
представить: представлена 
подписка: подписки 
исполнение: исполнении 
французский: французские 
пожалуйста: пожалуйста 
разместить: разместить 
суждено: суждено 
поблагодарить: поблагодарить 
близкий: близка 
предоставляться: предоставляются 
некоторый: некоторые 
замечание: замечания 
муслим: муслим 
колумбийский: колумбийского 
обратный: обратная 
копирование: копирования 
игра: игра 
добавить: добавить 
избранный: избранное 
сень: сенью 
исполнитель: исполнителя 
соглашение: соглашение 
отправить: отправить 
мочь: могут 
высоко: высоко 
партнёрский: партнерская 
ошибка: ошибки 
представиться: представьтесь 
поддержать: поддержи 
треклист: треклист 
любимый: любимые 
пользовательский: пользовательское 
взять: возьмите 
гора: горах 
социальный: социальные 
продюсер: продюсера 
событие: событие 
увидать: увидал 
сообщить: сообщите 
мы: нам 
согласовывать: согласовывайте 
реклама: рекламу 
сегодня: сегодня 
погибнуть: погибнуть 
угадать: угадай 
день: день 
программа: программа 
