мочь: могла могут мог могли 
твой: твоих твой твою твоя твои 
доллар: долларов 
глубина: глубине 
хит: хит 
ошибка: ошибки 
бесполезный: бесполезным 
вау: вау 
смеяться: смеешься 
озадачить: озадаченные 
вернуться: вернусь 
мама: мамы маме маму мама мамой 
сеть: сети 
спеть: спою 
партнёрский: партнерская 
угодный: угодно 
восторг: восторге 
ха: ха 
маленький: маленькая маленький маленькие 
плохой: хуже 
песня: песне песни 
оцепенение: оцепенении 
два: две 
наш: наши 
рушиться: рушится рушиться 
положить: положила 
ограбить: ограбили 
колыбельный: колыбельной 
круто: круто 
казаться: казалось кажется 
пить: пить 
оказаться: окажется 
каждый: каждый каждом 
радио: радио 
рождество: рождество 
программа: программах программа 
девочка: девочки девочка 
порядок: порядке 
кошмар: кошмаров 
должный: должно 
копилка: копилку 
обратный: обратная 
обращаться: обращаюсь 
любить: любит 
нравиться: нравится нравилось 
попросить: попросишь 
вокруг: вокруг 
работа: работа работы 
улица: улицу 
судьба: судьба 
взламывать: взламывали 
материал: материалов 
сиять: сияет 
засыпать: засыпай 
это: это 
мамочка: мамочки мамочка мамочку 
забыть: забуду 
молитва: молитвах 
игра: игра 
фотография: фотографии 
реклама: рекламу 
улыбаться: улыбаешься 
перевод: перевода переводы переводу перевод переводов 
вытереть: вытри 
поддержать: поддержи 
связь: связь 
ты: тебе тобой 
понравиться: понравился понравиться 
вместе: вместе 
произойти: произошло 
малышка: малышка 
рядом: рядом 
почему: почему 
видеть: видеть видишь видела вижу 
форум: форуме форум 
переживание: переживаний 
папочка: папочку папочка папочки папочке 
жаль: жаль 
пересмешник: пересмешник пересмешника 
показывать: показывают 
забавно: забавно 
перекатить: перекати 
выйти: выйти 
просто: просто 
сломать: сломаю 
ювелирный: ювелирный 
право: права 
немецкий: немецкие 
шутить: шутил 
возможность: возможность 
мой: мои 
сделать: сделаю сделать сделаем 
накопить: накопила 
вырасти: выросли 
сайт: сайт сайтом 
случаться: случается 
задеть: задело 
ночь: ночь 
дом: доме 
миля: мили 
упаковать: упаковала 
справиться: справимся 
общение: общение 
сердце: сердце 
разбить: разбило 
либо: либо 
плакать: плачешь плакать плакал плачь 
новар: новара 
мнение: мнений 
доставать: доставать 
солдатик: солдатик 
сестра: сестры 
английский: английские 
чувствовать: чувствовал чувствуем 
возможный: возможны 
другой: другую другое 
банк: банке 
подарок: подарки 
испанский: испанские 
правда: правда 
традиционный: традиционной 
добавить: добавить 
несоответствие: несоответствия 
угадать: угадай 
ощутить: ощутить 
папа: папе папой папа 
купить: купил купит купить 
глаз: глазах 
бриллиантовый: бриллиантовое 
знать: знаю знаем знать 
автор: авторам авторы авторами автор 
мы: нам нами 
выпрямиться: выпрямись 
некоторый: некоторые 
время: время 
смотреть: смотрю 
подарить: подарю 
отправить: отправить 
путаться: путается 
рождественский: рождественские 
любимый: любимые 
никакой: никаких 
планировать: планировали 
мелодия: мелодию 
детский: детские детской 
чалмерс: чалмерс 
понятный: понятны 
внутри: внутри 
эй: эй 
стрелять: стреляли 
слово: слов 
уехать: уехать уехал 
переехать: переехала переехал 
видеоклип: видеоклипы видеоклип 
звучать: звучать звучит 
запутывать: запутывает 
плохо: плохо 
ёлка: елку 
соглашение: соглашение 
леди: леди 
хотеть: хотел хочу хочет 
хотеться: хочется 
многое: многое 
который: котором которые которая которой 
сидеть: сижу 
треклист: треклист 
душа: души 
принадлежать: принадлежат 
предоставляться: предоставляются 
детство: детстве 
персональный: персональное 
тег: тегам 
обнять: обнять 
сторона: сторону 
уйти: ушел ушла 
стараться: стараюсь 
представить: представьте 
поблагодарить: поблагодарить 
политика: политика 
разъезд: разъездах 
разместить: разместить 
тихо: тихо 
пойти: пойти 
рейтинг: рейтинг 
однокомнатный: однокомнатную 
постоянно: постоянно 
очень: очень 
подписка: подписки 
конфиденциальность: конфиденциальности 
представиться: представьтесь 
карат: карат 
тысяча: тысячу 
клип: клипов 
ответственность: ответственности 
грустить: грустишь 
итальянский: итальянские 
весь: всем 
сжать: сожми 
мир: мир мире 
замечание: замечания 
пора: пор 
продавец: продавца 
заставить: заставлю 
популярный: популярные 
петь: поет 
пожалуйста: пожалуйста 
быстро: быстро 
сильный: сильнее 
свой: своей своим 
телевизор: телевизору 
копить: копила 
поле: поле 
еда: еду 
остановиться: остановиться 
дядя: дядя 
копирование: копирования 
работать: работать 
вспоминать: вспоминаю 
лишь: лишь 
стать: стало стал стала 
скучать: скучаешь 
деньга: денег деньги 
железный: железной 
социальный: социальные 
кружиться: кружится 
увидеть: увидели увидеть 
полагать: полагаю 
съесть: съесть 
помнить: помню 
оба: обе 
ругаться: ругались 
сумасшедший: сумасшедший 
вращаться: вращается 
жизнь: жизнь 
слишком: слишком 
говорить: говорил говорит 
дре: дре 
вещь: вещи 
калифония: калифонию 
дать: дать 
губка: губки 
французский: французские 
начинаться: начинается 
текст: текст 
доктор: доктора 
слёзка: слезки 
жить: жили 
бояться: боишься 
подросток: подростками 
сей: сих 
отказ: отказ 
год: год 
обещать: обещаю 
парад: парад 
начало: начала 
авторский: авторские 
зависеть: зависят 
хватать: хватало 
колледж: колледж 
диск: диском 
квартира: квартиру 
безумно: безумно 
защитить: защитить 
паблик: паблик 
пустой: пустом 
пытаться: пыталась пытаюсь 
сказать: сказала 
надолго: надолго 
интересный: интересное 
название: название 
день: день 
проснуться: проснемся 
именно: именно 
прийтись: пришлось 
улыбка: улыбку 
гордиться: гордилась 
загрузка: загрузка 
сообщить: сообщите 
сложиться: сложилось 
ложиться: ложись 
пользовательский: пользовательское 
авторизируться: авторизируйтесь 
кольцо: кольцо 
хэйль: хэйли 
новостной: новостных 
пожелание: пожелания 
лэйня: лэйни 
грабить: грабили 
назад: назад 
птичка: птичке 
сон: сном 
тихий: тише 
завести: завести 
понять: понять 
шея: шею 
главный: главная 
согласовывать: согласовывайте 
встретить: встретил 
привезти: привез 
