перевод: перевода переводы переводу перевод переводов 
страница: страница 
видеоклип: видеоклипы видеоклип 
социальный: социальные 
поддержать: поддержи 
бежать: бежать 
коробка: коробке 
связь: связь 
согласовывать: согласовывайте 
ты: тебе тобой 
мочь: могут 
понравиться: понравился понравиться 
целый: целый 
обогнать: обогнать 
ужин: ужин 
рука: рук рука 
домой: домой 
автор: авторами авторы автора авторам автор 
соглашение: соглашение 
сигарета: сигаретой 
хит: хит 
взгляд: взглядом 
ошибка: ошибки 
форум: форуме форум 
маленький: маленький 
шестизарядный: шестизарядный 
папа: папа папы 
работать: работает 
треклист: треклист 
принадлежать: принадлежат 
предоставляться: предоставляются 
сеть: сети 
ковбой: ковбой 
персональный: персональное 
выйти: выйти 
тег: тегам 
раскрыть: раскроет 
партнёрский: партнерская 
французский: французские 
револьвер: револьвер 
лёд: лёд 
приходить: приходит 
право: права 
немецкий: немецкие 
кухня: кухне 
крючок: крючка 
остальной: остальные 
текст: текст 
возможность: возможность 
мой: мои моих 
ловкость: ловкость 
ум: ума 
пуля: пуля 
какой: какими 
комната: комнату 
отказ: отказ 
песня: песне песни 
поблагодарить: поблагодарить 
политика: политика 
разместить: разместить 
парад: парад 
рейтинг: рейтинг 
сайт: сайт сайтом 
авторский: авторские 
наш: наши 
быстрый: быстрей быстрый быстрая 
роберт: роберта 
убегать: убегать 
подписка: подписки 
общение: общение 
конфиденциальность: конфиденциальности 
паблик: паблик 
самокрутка: самокрутка 
представиться: представьтесь 
свой: свой своего своей 
интересный: интересное 
прийти: придет 
каморка: каморке 
день: день 
кроссовок: кроссовках кроссовки 
крутой: крутые крутых 
клип: клипов 
пистолет: пистолет 
мнение: мнений 
ответственность: ответственности 
огонь: огне 
радио: радио 
найти: нашел 
запаковать: запакован 
детишки: детишки 
английский: английские 
вещь: вещами 
итальянский: итальянские 
сойти: сошла 
возможный: возможны 
из: изо 
должный: должно 
обратный: обратная 
сюрприз: сюрприз 
замечание: замечания 
долго: долго 
испанский: испанские 
странный: странными 
добавить: добавить 
замысел: замысел 
несоответствие: несоответствия 
популярный: популярные 
загрузка: загрузка 
поздно: поздно 
угадать: угадай 
спуск: спуск 
говорить: говорю 
волос: волосы 
пожалуйста: пожалуйста 
сообщить: сообщите 
знать: знаю 
материал: материалов 
мы: нам 
свисать: свисает 
некоторый: некоторые 
окинуть: окинет 
идти: идет 
пользовательский: пользовательское 
авторизируться: авторизируйтесь 
отправить: отправить 
принести: принесет 
болтать: болтаю 
программа: программа 
это: это 
любимый: любимые 
пожелание: пожелания 
копирование: копирования 
мелодия: мелодию 
рот: рта 
игра: игра 
ждать: ждал 
главный: главная 
реклама: рекламу 
