жизнь: жизнью жизнь жизни 
перевод: перевода переводы переводу перевод переводов 
смотреть: смотреть 
страница: страница 
живить: живи 
видеоклип: видеоклипы видеоклип 
социальный: социальные 
поддержать: поддержи 
кричать: кричать 
связь: связь 
согласовывать: согласовывайте 
мочь: могут можешь 
понравиться: понравился понравиться 
принять: прими 
управлять: управлять 
рождение: рождения 
реклама: рекламу 
автор: авторами авторы автора авторам автор 
соглашение: соглашение 
отпустить: отпусти 
хит: хит 
понимать: понимаешь 
перестать: перестань 
жить: живу жить 
делать: делаю 
ошибка: ошибки 
форум: форуме форум 
поучиться: поучиться 
заставлять: заставлять 
тревога: тревоги 
папа: папа 
треклист: треклист 
свой: своя своем своей 
видеть: видишь 
думать: думай 
опасный: опасны 
предоставляться: предоставляются 
принадлежать: принадлежат 
сеть: сети 
персональный: персональное 
выйти: выйти 
дело: дело деле 
тег: тегам 
партнёрский: партнерская 
понять: поймешь 
французский: французские 
происходить: происходят 
право: права 
немецкий: немецкие 
текст: текст 
сегодня: сегодня 
возможность: возможность 
посмотреть: посмотреть 
мой: мои мое 
твой: твоим 
показать: покажи 
разобраться: разберись 
отказ: отказ 
песня: песне песни 
олег: олег 
поблагодарить: поблагодарить 
проблема: проблемы 
политика: политика 
послушать: послушай послушать 
лгать: лжешь 
разместить: разместить 
парад: парад 
рейтинг: рейтинг 
сайт: сайт сайтом 
авторский: авторские 
наш: наши 
ночь: ночь 
спать: спишь 
оставить: оставь 
человек: людей 
очень: очень 
решение: решения 
лобачев: лобачев 
запад: запад 
подписка: подписки 
общение: общение 
конфиденциальность: конфиденциальности 
паблик: паблик 
небольшой: небольшие 
беспокоить: беспокоить 
знать: знает знаешь 
подпёвка: подпевках 
представиться: представьтесь 
интересный: интересное 
хотеть: хочу 
день: день 
надоедать: надоедать 
клип: клипов 
мнение: мнений 
ответственность: ответственности 
восток: восток 
радио: радио 
перемена: перемены 
английский: английские 
собственный: собственная 
событие: событие 
покинуть: покинь 
съездить: съезди 
итальянский: итальянские 
возможный: возможны 
весь: всем 
хороший: хорошие 
обратный: обратная 
замечание: замечания 
испанский: испанские 
добавить: добавить 
пример: примеры 
несоответствие: несоответствия 
популярный: популярные 
загрузка: загрузка 
угадать: угадай 
говорить: говорю 
пожалуйста: пожалуйста 
сообщить: сообщите 
должный: должна 
познание: познания 
знак: знаки 
материал: материалов 
мы: нам 
некоторый: некоторые 
я: мной 
пользовательский: пользовательское 
ерунда: ерунды 
авторизируться: авторизируйтесь 
отправить: отправить 
бороться: бороться 
программа: программа 
принимать: принимаю 
рассказывать: рассказывать 
это: это 
любимый: любимые 
освободить: освободи 
устать: устали 
пожелание: пожелания 
копирование: копирования 
бизнес: бизнесом 
мелодия: мелодию 
игра: игра 
получать: получаешь 
однажды: однажды 
главный: главная 
