перевод: перевода переводы переводу перевод переводов 
страница: страница 
видеоклип: видеоклипы видеоклип 
полоска: полоску 
социальный: социальные 
упасть: упала 
поддержать: поддержи 
падать: падать 
зелёный: зелёно 
связь: связь 
согласовывать: согласовывайте 
вчера: вчера 
мочь: могут 
понравиться: понравился понравиться 
любить: любят 
твой: твоих твой 
рождение: рождения 
друг: друга друг 
разозлиться: разозлилась 
автор: авторами авторы автора авторам автор 
бояться: боятся боюсь 
соглашение: соглашение 
рядом: рядом 
коричневый: коричневый 
хит: хит 
жизнь: жизнь 
ошибка: ошибки 
форум: форуме форум 
ботинок: ботинках 
правый: правы 
ты: тобой 
минимум: минимум 
никто: никто 
треклист: треклист 
продержаться: продержимся 
принадлежать: принадлежат 
предоставляться: предоставляются 
машина: машину 
сеть: сети 
персональный: персональное 
выйти: выйти 
просто: просто 
тег: тегам теги 
партнёрский: партнерская 
французский: французские 
любимый: любимых любимые 
напугать: напугать 
право: права 
немецкий: немецкие 
казаться: кажется 
текст: текст 
парад: парада парад 
возможность: возможность 
поселиться: поселились 
город: городе город 
мой: мои мою 
ум: ума 
отказ: отказ 
песня: песне песни 
поблагодарить: поблагодарить 
политика: политика 
звать: зовут 
помнить: помнить 
согласный: согласен 
разместить: разместить 
неплохой: неплоха 
рейтинг: рейтинг 
сайт: сайт сайтом 
авторский: авторские 
сойти: сойду 
наш: наши 
одетый: одеты 
дьявольский: дьявольский дьявольском 
день: дня день 
глупый: глупое 
ночь: ночь 
чувствовать: чувствую 
оставить: оставь 
говорить: говорят 
новый: новую нового 
вид: виду 
сказать: сказал 
подписка: подписки 
отец: отец 
общение: общение 
конфиденциальность: конфиденциальности 
паблик: паблик 
представиться: представьтесь 
интересный: интересное 
крайний: крайней 
тысяча: тысячу 
становиться: становится 
клип: клипов 
мнение: мнений 
ответственность: ответственности 
слово: словом слов 
радио: радио 
мера: мере 
всё: всё 
английский: английские 
порядок: порядке 
событие: событие 
забыть: забыл 
итальянский: итальянские 
иметься: имеется 
возможный: возможны 
сжать: сожми 
обратный: обратная 
белый: белый 
замечание: замечания 
испанский: испанские 
праздновать: праздновать 
лето: летом 
добавить: добавить 
поймать: поймать 
мама: мама 
холодный: холоднее 
несоответствие: несоответствия 
популярный: популярные 
загрузка: загрузка 
угадать: угадай 
лидер: лидеры 
папа: папой 
купить: купил 
халат: халаты 
пожалуйста: пожалуйста 
сообщить: сообщите 
сильный: сильнее 
знать: знаю 
смочь: сможет 
материал: материалов 
мы: нам 
некоторый: некоторые 
немного: немного 
пользовательский: пользовательское 
мёртвый: мертвы 
авторизируться: авторизируйтесь 
отправить: отправить 
туда: туда 
программа: программа 
паук: пауки 
это: это 
пожелание: пожелания 
копирование: копирования 
больно: больно 
влюбляться: влюбляться 
мелодия: мелодию 
один: одну 
стоить: стоит 
безопасный: безопаснее 
игра: игра 
рука: руку 
довольно: довольно 
главный: главная 
реклама: рекламу 
