перевод: перевода переводы переводу перевод переводов 
никак: никак 
остаться: остались остаться 
видеоклип: видеоклипы видеоклип 
социальный: социальные 
поддержать: поддержи 
связь: связь 
исчезнуть: исчезнешь 
местечко: местечка 
согласовывать: согласовывайте 
занять: заняло займет 
найти: нашла найти 
кожа: кожа 
понравиться: понравился понравиться 
мочь: могут могу 
нужно: нужно 
домой: домой 
автор: авторами авторы авторам автор 
соглашение: соглашение 
думать: думала 
хит: хит 
ошибка: ошибки 
форум: форуме форум 
исполнение: исполнении 
айлиш: айлиш 
мысль: мысли 
треклист: треклист 
принадлежать: принадлежат 
предоставляться: предоставляются 
сеть: сети 
дословно: дословно 
персональный: персональное 
выйти: выйти 
кость: кости 
тег: тегам теги 
хороший: получше 
партнёрский: партнерская 
французский: французские 
разум: разум разуме 
право: права 
немецкий: немецкие 
твёрдый: твердый 
текст: текст 
надеяться: надеюсь 
парад: парада парад 
возможность: возможность 
мой: мои моем 
замечательный: замечательно 
место: место 
ох: ох 
отказ: отказ 
песня: песне песни 
билли: билли 
выход: выход 
поблагодарить: поблагодарить 
политика: политика 
разместить: разместить 
почувствовать: почувствовать 
рейтинг: рейтинг 
сайт: сайт сайтом 
авторский: авторские 
такой: таких 
сделать: сделано 
наш: наши 
ночь: ночь 
добро: добро 
камень: камня 
пожалуй: пожалуй 
подписка: подписки 
здравствуй: здравствуй 
общение: общение 
конфиденциальность: конфиденциальности 
паблик: паблик 
представиться: представьтесь 
сердце: сердце 
свой: свой 
отсюда: отсюда 
интересный: интересное 
страх: страх 
хотеть: хочу 
выбраться: выберусь 
побороть: побороть 
клип: клипов 
мнение: мнений 
ответственность: ответственности 
радио: радио 
поиск: поиске 
пожаловать: пожаловать 
английский: английские 
год: лет 
итальянский: итальянские 
возможный: возможны 
вблизи: вблизи 
обратный: обратная 
замечание: замечания 
живой: живым живой 
испанский: испанские 
добавить: добавить 
несоответствие: несоответствия 
популярный: популярные 
загрузка: загрузка 
угадать: угадай 
лидер: лидеры 
один: одной 
покидать: покидаю 
пожалуйста: пожалуйста 
вариант: вариант 
сообщить: сообщите 
должный: должна 
разорвать: разорви 
знать: знаю 
материал: материалов 
мы: нам 
время: время 
некоторый: некоторые 
кусок: куски 
пользовательский: пользовательское 
авторизируться: авторизируйтесь 
снаружи: снаружи 
отправить: отправить 
программа: программа 
это: это 
любимый: любимые 
пожелание: пожелания 
копирование: копирования 
стекло: стекла 
сотня: сотню 
мелодия: мелодию 
хрупкий: хрупкое 
лишь: лишь 
игра: игра 
навсегда: навсегда 
спрятаться: спрятаться 
однажды: однажды 
главный: главная 
реклама: рекламу 
