перевод: перевода переводы переводу перевод переводов 
сердце: сердцу 
видеоклип: видеоклипы видеоклип 
социальный: социальные 
боль: боль 
поддержать: поддержи 
связь: связь 
воспользоваться: воспользуюсь 
голос: голосом 
согласовывать: согласовывайте 
ты: тебе 
мочь: могут 
понравиться: понравился понравиться 
спеть: спел спеть 
автор: авторами авторы авторам автор 
соглашение: соглашение 
причинить: причинит 
хит: хит 
исчерпать: исчерпаны 
хотеться: хочется 
форум: форуме форум 
ошибка: ошибки 
драться: драться 
слишком: слишком 
любить: любить 
треклист: треклист 
другой: другая другую другому 
принадлежать: принадлежат принадлежать принадлежала 
предоставляться: предоставляются 
сеть: сети 
ночь: ночи 
персональный: персональное 
просто: просто 
выйти: выйти 
тег: тегам теги 
партнёрский: партнерская 
приносить: приносил 
французский: французские 
право: права 
немецкий: немецкие 
текст: текст 
парад: парада парад 
возможность: возможность 
ломать: ломали 
свой: своим свои 
мой: мои 
отказ: отказ 
песня: песне песни песню 
поблагодарить: поблагодарить 
политика: политика 
слеза: слезы слёзы 
разместить: разместить 
влюбиться: влюбиться 
весна: весну 
поэтому: поэтому 
рейтинг: рейтинг 
сайт: сайт сайтом 
побеждать: побеждают 
авторский: авторские 
наш: наши 
холодно: холодно 
научиться: научиться 
слово: слова 
подписка: подписки 
общение: общение 
конфиденциальность: конфиденциальности 
паблик: паблик 
представиться: представьтесь 
устать: устал 
интересный: интересное 
хотеть: хочу 
клип: клипов 
мнение: мнений 
ответственность: ответственности 
прошлый: прошлую 
радио: радио 
английский: английские 
любовь: любовь 
ленточка: ленточке 
итальянский: итальянские 
возможный: возможны 
обратный: обратная 
замечание: замечания 
истратить: истрачены 
испанский: испанские 
понять: поняла 
добавить: добавить 
поцеловать: поцеловать 
чувствовать: чувствовала 
несоответствие: несоответствия 
популярный: популярные 
загрузка: загрузка 
угадать: угадай 
лидер: лидеры 
который: которая 
пожалуйста: пожалуйста 
равно: равно 
сообщить: сообщите 
забрать: забрать 
знать: знаю 
материал: материалов 
рука: руки 
плакать: плакать 
мы: нам 
некоторый: некоторые 
пользовательский: пользовательское 
проиграть: проиграю 
расцвести: расцветут 
авторизируться: авторизируйтесь 
отправить: отправить 
программа: программа 
грубый: груб 
чертовски: чертовски 
любимый: любимые 
пожелание: пожелания 
красивый: красивой 
копирование: копирования 
делить: делить 
мелодия: мелодию 
лишь: лишь 
игра: игра 
нарцисс: нарциссы 
главный: главная 
быть: буду 
реклама: рекламу 
