история: история 
перевод: перевода переводы переводу перевод переводов 
ненавидеть: ненавидеть 
страница: страница 
видеоклип: видеоклипы видеоклип 
социальный: социальные 
боль: боль 
отказаться: откажусь 
поддержать: поддержи 
связь: связь 
согласовывать: согласовывайте 
мочь: могут могу 
понравиться: понравился понравиться 
лёгкий: легче 
друг: друга друг 
такой: такое такие 
дать: дал 
автор: авторами авторы автора авторам автор 
позволить: позволит 
соглашение: соглашение 
отпустить: отпусти 
почему: почему 
хит: хит 
пытаться: пытайся пытаюсь 
пока: пока 
чувство: чувство 
форум: форуме форум 
ошибка: ошибки 
причинить: причинить 
один: одни 
жить: жить 
любить: любить люблю 
океан: океаны 
треклист: треклист 
резать: резать 
принадлежать: принадлежат 
предоставляться: предоставляются 
сеть: сети 
персональный: персональное 
выйти: выйти 
тег: тегам 
мой: моей мои 
сомнение: сомнений 
забывать: забывай 
твой: твоего твою 
партнёрский: партнерская 
французский: французские 
происходить: происходит 
право: права 
немецкий: немецкие 
перевести: перевести 
текст: текст 
возможность: возможность 
отказ: отказ 
песня: песне песни 
поблагодарить: поблагодарить 
политика: политика 
разместить: разместить 
долгий: дольше 
бесконечный: бесконечная 
парад: парад 
рейтинг: рейтинг 
сайт: сайт сайтом 
поступать: поступать поступаю 
авторский: авторские 
взгляд: взгляд 
наш: наши 
произносить: произносила 
уговаривать: уговаривать 
адель: адель 
измениться: изменилась 
благо: блага 
выживать: выживать 
слово: слова 
благодарный: благодарна 
идиом: идиома 
стоить: стой стоишь 
переубедить: переубедить 
часть: частям 
ольга: ольга 
безумно: безумно 
подписка: подписки 
общение: общение 
комаров: комарова 
конфиденциальность: конфиденциальности 
паблик: паблик 
представиться: представьтесь 
интересный: интересное 
хотеть: хочу 
жестоко: жестоко 
уйти: уйти 
судьба: судьбе 
клип: клипов 
мнение: мнений 
ответственность: ответственности 
хвост: хвост 
жалеть: жалею 
радио: радио 
всё: всё 
английский: английские 
любовь: любовь 
итальянский: итальянские 
подходить: подходи 
возможный: возможны 
обратный: обратная 
плен: плену 
далёкий: далеки 
замечание: замечания 
проходить: проходили 
испанский: испанские 
жизнь: жизни 
остаться: остаться 
добавить: добавить 
несоответствие: несоответствия 
популярный: популярные 
загрузка: загрузка 
быть: будем буду 
угадать: угадай 
темнота: темноте 
вид: вид 
разделять: разделяют 
вряд: вряд 
пожалуйста: пожалуйста 
совесть: совесть 
сообщить: сообщите 
близкий: ближе 
этот: эта 
материал: материалов 
притворяться: притворяться 
прекратить: прекрати 
облегчить: облегчить 
фраза: фразу 
мы: нам 
делать: делаем 
изменить: изменила 
некоторый: некоторые 
раскисать: раскисай 
знать: знаешь 
пользовательский: пользовательское 
сделать: сделать 
авторизируться: авторизируйтесь 
означать: означает 
ради: ради 
отлично: отлично 
что: чём 
отправить: отправить 
достойно: достойно 
программа: программа 
смотреть: смотришь 
это: это 
любимый: любимые 
пожелание: пожелания 
смочь: сможешь 
копирование: копирования 
мелодия: мелодию 
опустить: опусти 
игра: игра 
главный: главная 
реклама: рекламу 
