перевод: перевода переводы переводу перевод переводов 
история: истории 
ниже: ниже 
страница: страница 
сливаться: сливаются 
видеоклип: видеоклипы видеоклип 
наклоняться: наклоняюсь 
социальный: социальные 
ощущение: ощущения 
поддержать: поддержи 
дать: дам 
образ: образе 
особенный: особенный 
связь: связь 
согласовывать: согласовывайте 
мочь: могут 
божественный: божественен 
понравиться: понравился понравиться 
вместе: вместе 
скромный: скромный 
мой: моими мои моих 
зарабатывать: зарабатываю 
бог: бог 
подвох: подвоха 
автор: авторами авторы автора авторам автор 
высоко: высоко 
соглашение: соглашение 
ножницы: ножницы 
земля: землёй 
боль: болью боли 
хит: хит 
пластинка: пластинках 
слово: слово 
пыл: пылу 
золото: золото золотом 
жить: живу 
жизнь: жизнь 
хотеться: хочется 
форум: форуме форум 
хотя: хотя 
ошибка: ошибки ошибок 
стресс: стресса 
торопиться: торопиться 
слишком: слишком 
один: одни 
мир: миром мир 
настоящий: настоящий 
странно: странно 
вести: веду 
терять: теряя теряю теряешь 
треклист: треклист 
камень: камень 
смыкать: смыкал 
хотеть: хотят 
вещь: вещи 
направлять: направлять 
принадлежать: принадлежат 
предоставляться: предоставляются 
понимать: понимаете 
сеть: сети 
персональный: персональное 
горячиться: горячусь 
выйти: выйти 
просто: просто 
тег: тегам 
зелёный: зеленее 
взлетать: взлетаю 
партнёрский: партнерская 
французский: французские 
тягаться: тягайтесь 
разный: разные 
ходить: ходит 
право: права 
немецкий: немецкие 
казаться: кажется 
рассудок: рассудок 
свой: своём своего 
текст: текст 
давать: дают давая 
возможность: возможность 
начать: начнём 
сделать: сделай 
мистер: мистер 
обычный: обычная 
лёд: льдом 
делать: делал 
думать: думать 
сон: сна сон 
дизайн: дизайна 
быть: будут 
излечить: излечить 
напрягаться: напрягаться 
любовь: любви 
стоить: стою 
отказ: отказ 
который: которые 
получить: получил 
песня: песне песни 
травка: травка 
поблагодарить: поблагодарить 
политика: политика 
звать: зовут 
идея: идею 
выпивка: выпивкой 
врать: врут 
разместить: разместить 
парад: парад 
рейтинг: рейтинг 
некого: некому 
лгать: лгать 
причинять: причиняю 
сайт: сайт сайтом 
смеяться: смеются смеюсь 
авторский: авторские 
деньга: деньгами 
наш: наши 
потеряться: потерялся 
мотать: мотаю 
чувствовать: чувствую чувствуешь 
пропасть: пропал 
прикоснуться: прикоснись 
опрятный: опрятные 
снизу: снизу 
изя: изи 
говорить: говорят говорю 
постоянно: постоянно 
круто: круто 
жара: жару 
подписка: подписки 
общение: общение 
конфиденциальность: конфиденциальности 
паблик: паблик 
пустой: пустом 
представиться: представьтесь 
интересный: интересное 
страх: страх 
бумага: бумага 
поливать: поливаю 
выкладывать: выкладывают 
мозг: мозг 
навредить: навредить 
выше: выше 
оставить: оставлены 
иисус: иисус 
клип: клипов 
мнение: мнений 
ответственность: ответственности 
голова: головой 
муза: музы 
отпускать: отпускаю 
человек: люди 
блюдце: блюдце 
радио: радио 
всё: всё 
английский: английские 
неприкасай: неприкасаем 
краснеть: краснею 
пилить: пилю 
понять: поняли 
итальянский: итальянские 
возможный: возможны 
обратный: обратная 
лежать: лежу 
другой: другим 
замечание: замечания 
мимо: мимо 
обезболивать: обезболивающие 
банк: банк 
испанский: испанские 
открывать: открывай 
добавить: добавить 
подкармливать: подкармливаю 
закрытый: закрыты 
несоответствие: несоответствия 
крутиться: крутится 
загрузка: загрузка 
неподвижно: неподвижно 
угадать: угадай 
заглянуть: загляни 
часть: частью 
популярный: популярные 
шампанский: шампанское 
расти: расти 
пожалуйста: пожалуйста 
равно: равно 
сообщить: сообщите 
никакой: никакого 
бездвижно: бездвижно 
материал: материалов 
мидас: мидас 
трек: треки 
мы: нам 
некоторый: некоторые 
я: мной 
пользовательский: пользовательское 
спасть: спал 
авторизируться: авторизируйтесь 
словно: словно 
ведро: ведре 
пролетать: пролетает 
пусть: пусть 
бейк: бейк 
подносить: подношу 
отправить: отправить 
пересказывать: пересказывать 
глаз: глаз глаза 
программа: программа 
подумать: подумаю 
замечать: замечают 
хейтеры: хейтеры 
это: это 
любимый: любимые 
тот: те 
еда: еду 
пожелание: пожелания 
смочь: сможешь 
копирование: копирования 
трава: трава 
расслабиться: расслабиться 
больно: больно 
упад: упаду 
мелодия: мелодию 
восторг: восторг 
юз: юзу 
игра: игра 
последний: последний 
к: ко 
позволять: позволяют 
позади: позади 
факт: факты 
главный: главная 
ящик: ящике 
реклама: рекламу 
