перевод: перевода переводы переводу перевод переводов 
смотреть: смотреть 
страница: страница 
видеоклип: видеоклипы видеоклип 
нечестивый: нечестивое 
посреди: посреди 
социальный: социальные 
дрочить: дрочит 
прада: прада 
поддержать: поддержи 
грэмми: грэмми 
оставить: оставил 
связь: связь 
согласовывать: согласовывайте 
ты: тебе 
деньга: деньги 
понравиться: понравился понравиться 
потрахаться: потрахаться 
мочь: могут мог можешь 
нужно: нужно 
свой: своих свой 
расстёгивать: расстёгивает 
автор: авторами авторы автора авторам автор 
соглашение: соглашение 
шептать: шепчут 
мм: мм 
узнать: узнала 
хит: хит 
пока: пока 
который: которых которую 
устраивать: устраиваю 
форум: форуме форум 
хотеться: хочется 
ошибка: ошибки 
исполнение: исполнении 
треклист: треклист 
выгнать: выгнала 
о: обо 
принадлежать: принадлежат 
предоставляться: предоставляются 
сеть: сети 
ночь: ночи 
персональный: персональное 
выйти: выйти вышла 
просто: просто 
тег: тегам теги 
партнёрский: партнерская 
французский: французские 
право: права 
немецкий: немецкие 
такой: такого 
текст: текст 
возможность: возможность 
мой: мои 
драма: драму 
ким: ким 
отказ: отказ 
песня: песне песни 
поблагодарить: поблагодарить 
политика: политика 
разместить: разместить 
дать: дай 
парад: парад 
рейтинг: рейтинг 
сайт: сайт сайтом 
место: местах 
авторский: авторские 
девчонка: девчонка 
наш: наши 
должный: должен 
восседать: восседаю 
весь: всей 
мальчик: мальчик 
говорить: говорят говоришь 
постоянно: постоянно 
откинуться: откинулся 
подписка: подписки 
общение: общение 
конфиденциальность: конфиденциальности 
паблик: паблик 
лезть: лезь 
знать: знает знаешь 
представиться: представьтесь 
интересный: интересное 
тратить: трачу 
побывать: побывал 
баленсиаг: баленсиага 
клип: клипов 
мнение: мнений 
ответственность: ответственности 
человек: люди 
радио: радио 
кой: кое 
английский: английские 
любовь: любовь 
итальянский: итальянские 
возможный: возможны 
обратный: обратная 
замечание: замечания 
папочка: папочка 
испанский: испанские 
диван: диване 
добавить: добавить 
смит: смит 
несоответствие: несоответствия 
популярный: популярные 
загрузка: загрузка 
угадать: угадай 
дарить: дарит 
делать: делая 
пожалуйста: пожалуйста 
хотеть: хочешь 
родео: родео 
сообщить: сообщите 
фенди: фенди 
давать: даёт 
прикроить: прикрою 
материал: материалов 
упаковать: упаковать 
мы: нам 
некоторый: некоторые 
ребёнок: детей 
адресок: адресок 
грязный: грязный 
рианна: рианны 
пользовательский: пользовательское 
авторизируться: авторизируйтесь 
отправить: отправить 
везучий: везучая 
сэм: сэм 
замуж: замуж 
слышать: слышу 
программа: программа 
бордель: борделе 
это: это 
возбуждаться: возбуждается 
любимый: любимые 
малыш: малыш 
пожелание: пожелания 
копирование: копирования 
мелодия: мелодию 
звонить: звонит 
след: следы 
штаны: штаны 
игра: игра 
ома: ома 
хрень: хрени 
одеяло: одеяло 
главный: главная 
мамочка: мамочка 
реклама: рекламу 
заместить: замести 
петрас: петрас 
